Chinese	chinoise
Chinese	chinoises
Surgical	chirurgicales
surgery	chirurgie
Surgeon	Chirurgien
shock	choc
chocolate	chocolat
Chocolate	Chocolate
Chocolates	chocolats
shock	chocs
Choice	Choice
selected	choisi
selected	choisie
selected	choisies
choose	choisir
choose	choisiront
selected	choisis
choosing	choisissant
chooses	choisit
choice	choix
Choice	Choix
Cholet	Cholet
unemployment	chômage
unemployed	chômeur
shocking	choquant
shock	choque
shocked	choquée
choir	chorale
singers	choristes
thing	chose
things	choses
cabbage	chou
Christian	chrétienne
Christian	chrétiennes
Christ	Christ
Christianity	christianisme
Christina	Christina
Christine	Christine
Christopher	Christopher
Chronicles	Chroniques
chronicler	chroniqueur
chu	chu
Chu	Chu
Chuck	Chuck
Church	Church
drop	chute
falls	chutes
Cyprus	Chypre
These	ci
hereafter	ci-après
targets	cibles
above-cons	ci-contre
below	ci-dessous
Below	Ci-dessous
above	ci-dessus
cider	cidre
Cie	Cie
heaven	ciel
Heaven	Ciel
heavens	cieux
cigarette	cigarette
cemetery	cimetière
Cine	Cine
filmmaker	cinéaste
Filmmakers	cinéastes
cinema	cinema
movie	cinéma
Movie	Cinéma
cinematographic	cinématographique
Sinhalese	cinghalaise
five	cinq
Five	Cinq
fifty	cinquantaine
fifty	cinquante
fifth	cinquième
hanger	cintre
waisted	cintrée
circumscribes	circonscrit
circumstance	circonstance
circuit	circuit
circular	circulaire
circular	circulaires
circulation	circulation
circulate	circuler
wax	cire
circus	cirque
Circus	Cirque
cis	cis
Citadel	Citadelle
citation	citation
cites	cite
City	Cité
cited	citée
quote	citer
cited	cités
quote	citez
Citizen	Citizen
citizen	citoyen
Citizens	citoyennes
citizenship	citoyenneté
people	citoyens
lemon	citron
city	city
City	City
civil	civil
civil	civiles
civilization	civilisation
Civilization	Civilisation
Citizenship	civiques
clear	clair
clear	claire
Clear	Claire
clearly	clairement
clear	claires
clear	clairs
sparse	clairsemé
clan	clan
Clann	Clann
slap	claque
Clara	Clara
clarity	clarté
class	class
Class	Class
class	classe
Class	Classe
classified	classé
ranking	classement
Ranking	Classement
rank	classer
classes	classes
classical	classique
Claude	Claude
key	clé
key	clef
clemency	clémence
Clemency	Clémence
Clement	Clément
clerk	clerk
Clic	Clic
clichés	clichés
Clichy	Clichy
customer	client
customers	clientèle
customers	clientes
customers	clients
climatic	climatique
climate	climatiques
climates	climats
clinic	clinique
Clinic	Clinique
Clinton	Clinton
clips	clips
bell	cloche
Steeple	Clocher
bells	cloches
closed	clos
Closed	Clos
close	close
closing	clôture
nail	clou
nailed	cloués
Clovis	Clovis
club	club
Club	Club
clubs	clubs
Clubs	Clubs
cm	cm
Coaster	Coaster
Coat	Coat
coca	coca
pigs	cochons
Coco	Coco
cocoon	cocon
coconut	cocotier
code	code
heart	coeur
Heart	Coeur
heart	cœur
Heart	Cœur
hearts	cœurs
safe	coffre
box	coffret
cognac	cognac
bangs	cogne
cognitive	cognitifs
cohabitation	cohabitation
cohabit	cohabitent
consistency	cohérence
coherent	cohérent
coherent	cohérente
IOC	COI
headdress	coiffe
wearing	coiffés
hairdressing	coiffure
corner	coin
stuck	coincés
collar	col
Collar	Col
Colas	Colas
cold	cold
Cole	Cole
Colette	Colette
collaboration	collaboration
collage	collage
stuck	collaient
tights	collant
Collateral	collatéraux
glue	colle
Glue	Colle
collection	collecte
collect	collecter
collective	collectif
Collective	collective
collectively	collectivement
collectivity	collectivité
glued	collée
college	college
college	collège
College	Collège
colleague	collègue
colleagues	collègues
collar	collet
necklace	collier
hill	colline
seminar	colloque
Colm	Colm
Flatmates	colocataires
Columbus	Colomb
Colombia	Colombia
Colombia	Colombie
settler	colon
colonial	colonial
Colonial	coloniale
colony	colonie
Settlers	colons
colouration	coloration
colored	coloré
colossal	colossales
fight	combat
fighters	combattants
combinations	combinaisons
fuel	combustible
fuels	combustibles
combustion	combustion
come	come
Comedy	Comédie
actor	comédien
comedians	comédiens
comedy	comédies
comic	comique
committee	comité
committees	comités
ordered	commanda
commander	commandant
Commanders	Commandants
ordered	commandée
Command	Commandement
order	commander
Order	Commander
commands	commandes
ordered	commandés
order	commandez
as	comme
As	Comme
commemorates	commémore
began	commença
beginning	commençant
begins	commence
beginning	commencement
start	commencer
begin	commencera
how	comment
How	Comment
commented	commenta
comment	commentaire
Comment	Commentaire
comments	commentaires
commentator	commentateur
Commentators	commentateurs
comment	commenter
tradespeople	commerçants
trade	commerce
Trade	Commerce
shopping	commercial
Business	commerciale
business	commerciales
marketing	commercialisation
Business	commerciaux
commit	commettre
committed	commis
committed	commise
Committed	commises
commission	commission
commit	commit
common	common
Commonwealth	Commonwealth
common	commun
community	communauté
town	commune
Town	Commune
Towns	Communes
communication	communication
Communication	Communication
Communications	Communications
statement	communiqué
communicate	communiquer
releases	communiqués
Communist	Communist
Community	Community
common	communs
Comoros	Comores
Compact	compacts
companion	compagne
company	compagnie
comparable	comparables
comparing	comparant
Compare	comparateur
compares	compare
compared	comparé
compare	comparent
compare	comparer
compatible	compatible
countryman	compatriote
compatriots	compatriotes
compensated	compensa
compensates	compense
offset	compenser
competence	compétence
skills	compétences
competent	compétent
competent	compétentes
competent	compétents
compiling	compilant
compiler	compilateur
compilation	compilation
compiled	compilé
compile	compiler
lament	complainte
complements	compléments
full	complet
Complete	complete
Complete	Complete
Complete	complète
completed	complété
completely	complétement
round	complètent
complete	compléter
complex	complexes
complexity	complexité
complicity	complicité
complicate	compliquer
conspiracy	complot
plot	comploter
with	comportant
behavior	comportements
feature	comportent
include	comporter
include	comportera
component	composante
consists	compose
compound	composé
composite	composée
composed	composées
up	composent
compose	composer
compounds	composés
Composite	Composite
composer	compositeur
composers	compositeurs
included	comprenait
including	comprenant
Including	Comprenant
understand	comprendre
understands	comprenne
include	comprennent
tablets	comprimés
counted	comptabilisés
accountant	comptable
Counting	comptage
spot	comptant
account	compte
Account	Compte
count	comptent
count	compter
accounts	comptes
counter	compteur
count	comptez
counter	comptoir
counters	comptoirs
Computer	Computer
Count	Comte
county	comté
cunt	con
grantor	concédant
Focusing	concentrant
Concept	Concept
design	conception
designs	conceptions
Concerning	Concernant
concerns	concerne
concerned	concernées
concerned	concernés
concert	concert
Concert	Concert
concerto	concerto
design	concevoir
council	concile
concise	concis
concluded	conclu
close	conclure
Conclusion	Conclusion
concludes	conclut
Concord	Concorde
competition	concours
Competition	Concours
concrete	concret
materializes	concrétise
Concrete	concrets
designed	conçu
concubine	concubine
competition	concurrence
Competing	concurrente
competitors	concurrents
condemns	condamne
sentenced	condamnés
condition	condition
conditioned	conditionné
Conditional	conditionnelle
packing	conditionnement
terms	conditions
Condom	Condom
conductor	conducteur
lead	conduira
lead	conduire
lead	conduisent
pipe	conduit
driving	conduite
piping	conduites
cone	cône
confederation	confédération
conference	conférence
lecturer	conférencier
confetti	confettis
confidence	confiance
confident	confiants
confidential	confidentielles
says	confie
Entrusted	Confié
entrust	confier
configuration	configuration
borders	confins
confirmation	confirmation
confirmed	confirmée
confirm	confirmer
candied	confite
conflict	conflit
confuse	confondez
confused	confondus
true	conforme
accordance	conformément
comply	conformes
comfort	confort
comfortable	confortable
reinforces	conforte
confusion	confusion
Congo	Congo
Congolese	congolais
Congolese	Congolais
Congolese	congolaise
congregation	congrégation
congress	congrès
Congress	Congrès
joint	conjoint
Joint	conjointe
knew	connaissais
knowledge	connaissance
Knowledge	connaissances
connoisseur	connaisseur
know	connaissez
know	connaissons
knows	connaît
experience	connaîtra
know	connaitre
connected	connecté
bullshit	connerie
related	connexe
connection	connexion
connotation	connotation
known	connu
Known	Connu
known	connue
known	connues
known	connus
conquer	conquérir
conquest	conquête
won	conquis
conquered	conquise
dedicated	consacré
dedicated	consacrée
devote	consacrer
devote	consacrera
devoted	consacrés
awareness	conscience
conscious	consciente
consecutively	consécutivement
council	conseil
advisor	conseiller
Advisor	Conseiller
Advisor	conseillère
Advisors	conseillers
advice	conseils
consent	consentement
agreed	consenti
result	conséquence
aftermath	conséquences
consequent	conséquent
keeping	conservant
conservative	conservateur
Conservatives	conservateurs
Preservation	Conservation
Conservatory	Conservatory
preserve	conserve
preserved	conservé
keep	conserver
consideration	considération
considered	considéré
consider	considérer
consider	considérons
instructions	consignes
consisted	consista
was	consistait
consistency	consistance
is	consiste
console	console
consoles	consoles
Consolidated	consolidés
consumption	consommation
consume	consomment
consume	consommer
conspiracy	conspiration
constantly	constamment
Constancy	Constance
constant	constant
constant	constante
Constantine	Constantine
finding	constat
finds	constate
Recorded	constatées
note	constater
Constituent	constituante
made	constitué
are	constituent
constitute	constituer
constitute	constituera
constitution	constitution
building	construction
constructions	constructions
build	construire
built	construit
Built	Construit
Constructed	Construite
built	construites
consul	consul
consultations	consultations
Check	Consultez
consume	consumer
contact	contact
Contact	Contact
contacted	contacté
contact	contacter
Contacts	contacts
contaminate	contaminer
story	conte
Contemporary	contemporaine
contemporary	contemporains
containing	contenant
Containers	conteneurs
contain	contenir
content	content
happy	contente
contents	contenu
contents	contenus
tales	contes
Tales	Contes
contestation	contestation
contest	contestent
contain	contiennent
contains	contient
Continental	continentale
contingency	contingence
quotas	contingents
continuous	continu
continues	continue
continued	continué
continue	continuer
continuity	continuité
outline	contour
Contraceptive	contraceptive
contracts	contracte
contracted	contractée
contract	contracter
contraction	contraction
constraint	contrainte
constraints	contraintes
contrary	contraire
Contrary	Contrairement
contract	contrat
against	contre
Against	Contre
reluctantly	contrecoeur
contradicts	contredit
countries	contrées
Offenders	contrevenants
ratepayer	contribuable
contributes	contribue
contribution	contribution
control	contrôle
Controlled	contrôlé
Controlled	contrôlée
controller	contrôleur
controversial	controversée
convinces	convainc
convince	convaincre
convalescence	convalescence
properly	convenablement
convenience	convenance
suit	convenir
convention	convention
Convention	Convention
conversation	conversation
conversion	conversion
convictions	convictions
invites	convie
suit	conviendra
appropriate	convient
diners	convives
user-friendly	convivial
friendly	conviviale
friendly	conviviales
Convoys	convois
convene	convoque
convened	convoquée
summoned	convoqués
Cook	Cook
cool	cool
cooperate	coopérer
coordinates	coordonne
coordinated	coordonnée
contact	coordonnées
guys	copains
copy	copie
hearty	copieuse
hearty	copieux
rooster	coq
shell	coque
shells	coques
Horn	Cor
coral	corail
Coral	coralliens
rope	corde
shoemaker	cordonnier
Korea	Corée
Korean	coréen
Korean	coréenne
horns	cornes
Corporations	corporations
body	corporelle
Body	corporels
body	corps
Body	Corps
correct	correct
correct	correcte
correctly	correctement
correct	corrects
matches	correspond
corresponding	correspondant
corresponding	correspondante
match	correspondent
correspond	correspondre
Corrèze	Corrèze
corrected	corrigées
correct	corriger
corroborate	corroborer
corrupt	corrompu
corrupt	corrompue
corrosion	corrosion
Corsican	corse
Cosmetics	cosmétiques
cosmopolitan	cosmopolite
cost	cost
costume	costume
costume	costumes
odds	cote
COTE	COTE
coast	côte
Coast	Côte
next	coté
side	côté
Side	Côté
hills	coteaux
ribs	côtes
coastal	côtier
Coastal	côtière
Coastal	côtières
Coastal	côtiers
Cotillard	Cotillard
contributions	cotisations
cotton	coton
Cotton	Cotton
neck	cou
Coubertin	Coubertin
layer	couche
diapers	couches
Cuckoo	Coucou
cast	coulées
flow	coulent
flow	couler
color	couleur
colors	couleurs
coulis	coulis
corridor	couloir
corridors	couloirs
Council	Council
countries	countries
Country	country
Country	Country
blow	coup
guilty	coupable
cutting	coupe
Cutting	Coupe
clipped	coupé
cut	coupée
cut	coupées
cuts	coupes
Cups	Coupes
couple	couple
couples	couples
cuts	coupures
court	cour
Court	Cour
courageously	courageusement
brave	courageux
fluently	couramment
current	courant
Current	Courant
current	courants
Currents	Courants
curve	courbe
curves	courbes
runner	coureur
run	courir
mail	courrier
price	cours
race	course
Race	Course
racing	courses
short	court
Short	Court
short	courte
short	courtes
short	courts
ran	couru
run	courue
cousin	cousin
cushion	coussin
cout	cout
cost	coût
costs	coûte
knives	couteaux
expensive	coûteuse
costs	coûts
usages	coutumes
customary	coutumières
Couture	Couture
seamstress	couturière
lid	couvercle
covered	couvert
Covered	couverte
cutlery	couverts
covers	couvre
Covers	Couvre
Covent	Covent
Coward	Coward
CPU	CPU
CR	CR
crab	crabe
Craig	Craig
fear	craindre
Cramer	Cramer
notches	crans
cracked	craqué
horsewhip	cravache
tie	cravate
pencil	crayon
creators	créateurs
creative	créatif
creation	création
Creations	créations
creativity	créativité
nursery	crèche
credibility	crédibilité
credible	crédibles
credit	crédit
Credit	Crédit
credits	crédits
creates	crée
Created	Crée
created	créé
created	créée
Creek	Creek
create	créer
Created	créés
battlements	créneaux
pancake	crêpe
creperie	crêperie
pancakes	crêpes
twilight	crépuscule
digging	creusement
dig	creuser
crucible	creuset
hollow	creux
shrimp	crevettes
cry	cri
Cricket	Cricket
Cree	crie
shout	crient
shout	crier
crime	crime
Crimea	Crimée
crimes	crimes
Criminal	criminelle
Crimson	Crimson
cove	crique
crisis	crise
crises	crises
Critics	Critics
criticizing	critiquant
criticized	critiqué
criticized	critiquée
Croatia	Croatia
Croatia	Croatie
believe	croire
believe	crois
crosses	croise
intersecting	croisent
cruise	croisière
growth	croissance
growing	croissant
growing	croissants
grow	croître
crunch	croquer
sketch	croquis
Cross	Cross
believed	croyait
belief	croyance
beliefs	croyances
Believers	croyants
vintage	cru
crucial	cruciales
cruel	cruel
crus	crus
cryptographic	cryptographique
Cuba	Cuba
Cuban	cubain
cube	cube
leather	cuir
leathers	cuirs
cooking	cuisine
Cooking	Cuisine
kitchenette	cuisinette
cook	cuisinier
cooked	cuit
Terracotta	cuite
copper	cuivre
ass	cul
panties	culottes
Worship	cultes
cultivates	cultive
cultivated	cultivé
culture	culture
Culture	Culture
culturally	culturellement
Cultural	culturels
cumin	cumin
cup	cup
cure	cure
priest	curé
Priest	Curé
Curepipe	Curepipe
curious	curieux
curiosity	curiosité
Curtis	Curtis
Cust	Cust
tanks	cuves
bicycle	cyclables
cycle	cycle
cycles	cycles
cyclic	cyclique
cyclist	cycliste
cyclists	cyclistes
cyclone	cyclone
cylinder	cylindre
d	d
of	d'
D	D
D4	D4
da	da
Da	Da
Dag	Dag
deign	daigne
Daimler	Daimler
daimyo	daimyo
Dali	Dali
lady	dame
ladies	dames
Ladies	Dames
checkerboards	damiers
Damon	Damon
Dan	Dan
Dance	Dance
Denmark	Danemark
danger	danger
dangerous	dangereuses
dangerous	dangereux
Danie	Danie
in	dans
In	Dans
dancing	dansant
dance	danse
dance	dansent
dances	danses
Dar	Dar
dark	dark
date	date
Dates	Dates
Dati	Dati
dates	dattes
dolphin	dauphin
Dave	Dave
David	David
Davis	Davis
Dawson	Dawson
day	day
Days	Days
DC	DC
from	de
From	De
DE	DE
Dead	Dead
dealers	dealers
land	débarquer
rid	débarrasser
debauchery	débauche
debit	débit
Unlocked	débloqué
unblock	débloquer
overflowing	déborde
outlet	débouché
uncork	déboucher
standing	debout
debris	débris
doing	débrouille
beginning	début
beginner	débutant
beginners	débutants
begins	débute
start	débuter
infancy	débuts
decadence	décadence
died	décédée
decency	décence
decade	décennie
decades	décennies
decentralization	décentralisation
disappointment	déception
death	décès
tore	déchira
fallen	déchu
decided	décidé
decide	décidera
decide	décideront
decided	décidés
decision	décision
decisions	décisions
declared	déclara
declarer	déclarant
statement	déclaration
says	déclare
declared	déclaré
declare	déclarer
triggers	déclenche
trigger	déclencher
declined	décliné
Deco	déco
decomposition	décomposition
casual	décontractée
decor	décor
decoration	décoration
decorations	décorations
decorations	décors
cutting	découpage
cut	découpées
discovered	découvert
discovery	découverte
Discovery	Découverte
discoveries	découvertes
discover	découvrent
discover	découvrir
discover	découvrirez
discover	découvriront
described	décrit
described	décrite
described	décrits
describing	décrivant
stall	décrochage
unhook	décrocher
decreasing	décroissance
disappointed	déçu
disappointed	déçue
disappointed	déçus
disdains	dédaigne
in	dedans
Dedicated	dédiée
dedicate	dédier
deduct	déduire
Dee	Dee
Deer	Deer
failure	défaillance
undone	défait
fault	défaut
defects	défauts
defends	défend
defend	défendent
defense	défense
defensive	defensive
challenge	défi
Challenge	Défi
mistrustful	défiant
challenge	défient
parade	défilé
parade	défilent
defined	défini
defined	définies
final	définitif
definitive	définitive
defunct	défunte
releases	dégage
thaw	dégel
thawed	dégelé
disgust	dégoût
degraded	dégradée
disguised	déguisé
out	dehors
dei	dei
already	déjà
Already	Déjà
lunch	déjeuné
breakfast	déjeuner
notice	délai
time	délais
delegation	délégués
deliberately	délibérément
delicate	délicat
delicious	délicieux
delimited	délimité
delimit	délimiter
delirious	délirant
Delirious	Delirious
offense	délit
issued	délivré
tomorrow	demain
asked	demandais
calling	demandant
demand	demande
required	demandé
ask	demandent
ask	demander
Applications	demandes
applicant	demandeur
gait	démarche
steps	démarches
out	démarque
out	démarquer
start-up	démarrage
starts	démarre
start	démarrer
Unmasked	démasqué
moves	déménage
move	déménagement
dementia	démence
demented	dément
resident	demeurant
residence	demeure
remain	demeurent
half	demi
removed	démis
resigned	démissionné
democracy	démocratie
democratic	démocratique
damsel	demoiselle
ladies	demoiselles
demolition	démolition
demons	démons
Demonstrative	démonstratifs
demonstrations	démonstrations
shown	démontré
demonstrate	démontrer
Den	Den
counts	dénombre
denomination	dénomination
called	dénommée
denounces	dénonce
denounce	dénoncer
denunciation	dénonciation
Denunciations	dénonciations
denouement	dénouement
density	densité
dentist	dentiste
Help	Dépannage
help	dépanner
departure	départ
Departmental	départementale
county	départementales
departments	départements
departures	départs
exceeds	dépasse
exceed	dépasser
scenery	dépaysement
Depeche	Depeche
portrayed	dépeint
addiction	dépendance
dependent	dépendant
dependent	dépendent
depend	dépendra
depend	dépendre
spend	dépenser
screening	dépistage
screenings	dépistages
moving	déplaçait
moves	déplace
displaced	déplacé
move	déplacement
displeasure	déplaisir
Fold	Dépliant
deployment	déploiement
deplorable	déplorable
deplores	déplore
deploying	déployant
deployed	déployés
displeased	déplu
filed	déposé
file	déposer
deposit	dépôt
Deposit	Dépôt
clearance	dépouille
bare	dépouillé
free	dépourvue
Depth	Depth
from	depuis
deputy	député
MP	députée
der	der
Der	Der
drift	dérive
latest	dernier
latest	dernière
recently	dernièrement
latest	dernières
Latest	derniers
place	déroulé
place	déroulée
place	déroulées
development	déroulement
unroll	dérouler
place	déroulera
unfold	déroulerait
unfolded	déroulèrent
behind	derrière
OF	DES
From	Dès
disagreement	désaccord
disabled	désactivée
defused	désamorcé
Descartes	Descartes
down	descend
down	descendait
descendants	descendance
descendant	descendant
descent	descente
description	description
desert	desert
Desert	Désert
deserted	déserte
desperately	désespérément
despair	désespoir
disinherited	déshérités
dehumanized	déshumanisé
designed	désigné
designated	désignée
designated	désignées
designers	designers
disillusions	désillusions
disinfectant	désinfectant
disintegration	désintégration
Detoxification	désintoxication
desire	désir
Desire	Desire
desire	désirer
eager	désireux
desires	désirs
disclaimer	désistement
Gardens	Desjardins
desolation	désolation
sorry	désolée
disorder	désordre
henceforth	désormais
release	desserrage
dessert	dessert
desserts	desserts
Served	desservie
Served	desservis
drawing	dessin
draftsman	dessinateur
draws	dessine
cartoon	dessinée
draw	dessiner
drawings	dessins
above	dessus
destabilized	déstabilisé
recipient	destinataire
destinations	destinations
destiny	destinée
destructive	destructeur
destruction	destruction
destruction	destructions
detached	détaché
retailers	détaillants
detailed	détaillé
Detailed	détaillée
details	détails
relaxed	détendu
hold	détenir
relaxation	détente
holder	détenteur
detained	détenu
detergent	détergent
determined	déterminé
determine	déterminer
determined	déterminés
hate	déteste
away	détournent
divert	détourner
Detractors	détracteurs
detriment	détriment
Detroit	Detroit
destroy	détruire
destroy	détruisent
destroyed	détruites
destroyed	détruits
debt	dette
liability	dettes
two	deux
second	deuxième
Second	Deuxième
Deux-Sèvres	Deux-Sèvres
had	devais
should	devait
before	devant
developed	développé
developed	développée
development	développement
Development	Développement
develop	développer
developed	développés
become	devenir
become	devenue
become	deviendra
become	deviendront
becomes	devient
quotation	devis
currency	devise
Currency	devises
duty	devoir
homework	devoirs
must	devons
will	devra
should	devraient
should	devrait
should	devriez
dha	dha
di	di
Di	Di
diabetes	diabète
diagnosis	diagnostic
diagonal	diagonale
Dial	Dial
dialectic	dialectique
dialogue	dialogue
Dialogue	Dialogue
diamond	diamant
Diamond	Diamond
Diana	Diane
diaspora	diaspora
Dice	Dice
dictator	dictateur
Didier	Didier
die	die
Diem	Diem
god	dieu
gods	dieux
delayed	différé
differently	différemment
difference	différence
Disputes	différends
different	différente
different	différentes
Different	Différentes
different	différents
difficult	difficile
Difficult	Difficile
difficult	difficiles
difficulty	difficulté
broadcasting	diffusant
broadcasts	diffuse
broadcast	diffusent
broadcast	diffuser
Broadcasting	Diffusion
digest	digérer
Digestive	digestives
Digital	digitales
worthy	digne
dignity	dignité
dilatation	dilatation
dilemma	dilemme
Sunday	dimanche
Sunday	Dimanche
Sundays	dimanches
dimension	dimension
dimensions	dimensions
tithes	dîmes
diminished	diminué
Dind	Dind
turkey	dinde
dinner	dîné
dinner	diner
dinner	dîner
dinosaur	dinosaure
graduate	diplômé
say	dira
say	dire
direct	direct
direct	directe
directly	directement
director	directeur
Director	Directeur
direction	direction
directions	directions
Directory	Directoire
headmistress	directrice
Headmistress	Directrice
Direct	directs
According	dires
dirhams	dirhams
headed	dirigea
leader	dirigeant
leadership	dirigeants
Directed	dirigée
lead	diriger
Dirk	Dirk
say	dis
said	disaient
said	disait
saying	disant
followers	disciples
discipline	discipline
disciplines	disciplines
discontinuous	discontinu
speech	discours
Discovery	Discovery
discreet	discret
discrete	discrets
discussions	discussions
discussed	discuté
says	dise
Disney	Disney
say	disons
disappear	disparaitre
disappear	disparaître
disparate	disparates
Disparities	disparités
gone	disparu
disappeared	disparue
disappeared	disparut
available	disponible
Available	Disponible
available	disponibles
features	dispose
arranged	disposées
dispose	disposer
device	dispositif
devices	dispositifs
provision	disposition
disproportionate	disproportionné
played	disputé
fight	disputer
disk	disque
discs	disques
Floppy	disquette
hide	dissimuler
deterred	dissuadé
distance	distance
separate	distinct
separate	distincte
Separate	distinctes
distinctions	distinctions
distinguished	distingué
Distractions	distractions
forgetful	distrait
distributed	distribué
Distributed	distribuée
Distributors	distributeurs
district	district
District	District
districts	districts
said	dit
called	dite
say	dites
diverse	diverse
various	diverses
entertainment	divertissement
dividends	dividendes
divided	divisé
divided	divisée
division	division
divorce	divorce
divorced	divorcé
ten	dix
Ten	Dix
eighteen	dix-huit
decade	dizaine
tens	dizaines
DJ	DJ
Djibouti	Djibouti
do	do
Do	Do
Doc	Doc
docile	docile
dock	dock
Dock	Dock
doctor	docteur
Doctoral	doctorales
Ph.D.	Doctorat
doctrine	doctrine
Doctrine	Doctrine
document	document
Documentary	Documentaire
librarian	documentaliste
documentation	documentation
Dodge	Dodge
Dog	Dog
doge	doge
dogmas	dogmes
finger	doigt
fingers	doigts
have	dois
must	doit
Must	Doit
must	doivent
Dole	Dole
Doll	Doll
dollar	dollar
dollars	dollars
Doloris	Doloris
dom	dom
Dom	Dom
area	domaine
Area	Domaine
areas	domaines
domestic	domestique
home	domestiques
domiciliation	domiciliation
dominant	dominant
dominates	domine
dominated	dominée
dominate	dominent
dominate	dominer
Domini	Domini
Dominique	Dominique
Dominoes	Dominoes
damage	dommage
damage	dommages
gift	don
therefore	donc
Therefore	Donc
dungeons	donjons
Donn	Donn
giving	donnant
gives	donne
given	donné
data	données
give	donner
donors	donneurs
donations	dons
whose	dont
boost	doper
Dora	Dora
Dordogne	Dordogne
golden	doré
golden	dorée
Henceforth	Dorénavant
sleeping	dormaient
slept	dormi
sleep	dormir
back	dos
file	dossier
records	dossiers
endowment	dotation
with	doté
customs	douane
Customs	Douane
double	double
doubling	doublement
double	doubler
fresh	douce
Fresh	Douce
gently	doucement
sweetness	douceur
shower	douche
gifted	douée
Douglas	Douglas
pain	douleurs
doubt	doute
doubtful	douteux
sweet	doux
dozen	douzaine
twelve	douze
twelfth	douzième
dr	dr
Dr.	Dr
dragon	dragon
Dragon	Dragon
dredge	draguer
dramatic	dramatique
Dramatic	dramatiques
playwright	dramaturge
flag	drapeau
drastically	drastiquement
Dre	Dre
dread	dread
dream	dream
stands	dresse
prepared	dressés
Driven	Driven
drug	drogue
drugs	drogues
right	droit
right	droite
right-handed	droitier
rights	droits
funny	drôle
Druid	Druide
due	dû
Dubai	Dubaï
doubtfully	dubitatif
Dublin	Dublin
duke	duc
Duck	Duck
due	due
duel	duel
Duke	Duke
dune	dune
Dunn	Dunn
Dunne	Dunne
duo	duo
Duquesne	Duquesne
hard	dur
durable	durable
during	durant
hardening	durcissement
tough	dure
duration	durée
hard	dures
Hard	durs
Dutch	Dutch
dynamic	dynamique
Dynamic	Dynamique
dynamism	dynamisme
malfunction	dysfonctionnements
e	e
E	E
E.	E.
Eagles	Eagles
Earth	Earth
Easy	Easy
water	eau
Water	Eau
waters	eaux
frolics	ébats
landslides	éboulements
spreads	écarte
spread	écarter
ecclesiastical	ecclésiastique
ecclesiastical	ecclésiastiques
scaffold	échafaud
exchanged	échangé
exchanged	échangées
exchange	échanger
exchange	échanges
escapes	échappe
escaped	échappé
breakaway	échappée
escape	échapper
deadlines	échéances
timetable	échéancier
chess	échecs
Echelon	Echelon
scan	échographie
fails	échoue
fail	échouer
Lightning	Éclair
lighting	éclairage
lighting	éclairant
cloudy	éclaircies
clear	éclaircir
enlightened	éclairé
eco	eco
School	Ecole
school	école
schoolchildren	écoliers
Ecology	Écologie
green	écologique
green	écologiques
ecologist	écologiste
economy	économie
Economy	Économie
economic	économique
economically	économiquement
Economic	économiques
bark	écorce
Scottish	écossais
Scotland	Écosse
ecosystem	écosystème
flowing	écoulant
past	écoulée
flow	écoulement
listening	écoute
listen	écouté
listen	écouter
screen	écran
overwhelming	écrasante
crushes	écrase
crushed	écrasé
crush	écraser
crushed	écrasés
write	écrire
written	écrit
written	écrite
writer	écrivain
Writer	Écrivain
writer	écrivaine
write	écrivent
reef	écueil
stable	écurie
stalls	écuries
equerry	écuyer
ed	ed
Ed	Ed
Eden	Eden
buildings	édifices
Edition	Edition
edition	édition
Edition	Édition
editions	éditions
Editions	Éditions
Edouard	Edouard
Eduardo	Eduardo
educator	éducateur
educative	éducatif
educational	éducatives
Edward	Edward
clears	efface
erasure	effacement
delete	effacer
effective	effectif
workforce	effectifs
effective	effective
effectively	effectivement
perform	effectuer
perform	effectuera
effect	effet
effective	efficace
effectively	efficacement
effective	efficaces
effectiveness	efficacité
brushes	effleure
striving	efforcent
fright	effroi
equal	égale
also	également
Also	Également
equal	égales
Equality	Egalité
equality	égalité
Equality	Égalité
misplaced	égarés
Church	Église
churches	églises
Churches	Églises
sewer	égout
Egypt	Egypte
Egypt	Égypte
Eh	Eh
ejaculation	éjaculation
el	el
El	El
elaboration	élaboration
momentum	élan
widen	élargir
enlargement	élargissement
elastic	élastique
Eldorado	Eldorado
electorate	électeurs
election	élection
elections	élections
electricity	électricité
electrical	électrique
Power	électriques
electromechanical	électromécanique
electron	électron
elegant	élégant
Elegant	élégante
items	éléments
Elephant	Elephant
breeding	élevage
elevation	élévation
student	élève
high	élevé
high	élevée
high	élevées
raise	élever
students	élèves
high	élevés
remove	éliminer
Elisabeth	Elisabeth
elite	élite
elite	élites
Elizabeth	Elizabeth
Elizabeth	Élizabeth
Ella	Ella
it	elle
It	Elle
Ellen	Ellen
they	elles
They	Elles
ellipse	ellipse
Elliptical	elliptiques
Ellis	Ellis
praise	éloge
praise	éloges
Eloi	Eloi
away	éloigner
remote	éloignés
elongation	élongation
eloquence	éloquence
elected	élu
elected	élue
Elected	Élus
Email	e-mail
emancipation	émancipation
packing	emballage
packed	emballée
Embedded	embarqué
hiring	embauche
hire	embaucher
hired	embauchés
Embedded	Embedded
immediately	emblée
emblematic	emblématique
mouth	embouchure
fire	embrasement
th	ème
transmitter	émetteur
emigrate	émigrer
Emily	Emily
Emirates	Émirats
issued	émis
Emissaries	émissaires
emission	émission
issued	émit
Emma	Emma
taking	emmenant
takes	emmène
led	emmenée
drive	emmener
Emotional	émotionnelle
emotionally	émotionnellement
moving	émouvant
seized	emparé
empathy	empathie
prevented	empêcha
prevents	empêche
impediment	empêchement
prevent	empêchent
prevent	empêcher
stacking	empilement
location	emplacement
locations	emplacements
employment	emploi
Employment	Emploi
jobs	emplois
employee	employé
employees	employés
employers	employeurs
carrying	emportant
won	emporté
carry	emporter
jailed	emprisonné
imprisoned	emprisonnée
borrowing	emprunt
borrows	emprunte
borrow	emprunter
borrowed	empruntés
affected	ému
emulsion	émulsion
in	en
In	En
frame	encadrer
framed	encadrés
pregnant	enceinte
incense	encens
chains	enchaîne
enclave	enclave
nick	encoche
notches	encoches
against	encontre
yet	encore
Yet	Encore
encourages	encourage
encouraged	encouragea
encouraged	encouragée
encourage	encourager
outstanding	encours
encyclopedia	encyclopédie
end	end
End	End
indebted	endetté
damaged	endommagé
damaged	endommagée
damage	endommager
sleep	endormir
Enduro	Enduro
energy	énergie
upset	énerve
childhood	enfance
child	enfant
children	enfants
Children	Enfants
hell	enfer
closed	enfermé
Underworld	enfers
finally	enfin
push	enfoncer
flee	enfuir
commits	engage
engaged	engagé
commitment	engagement
Commitments	engagements
engage	engager
engaged	engagés
beget	engendrer
machine	engin
engineering	engineering
covers	englobe
umpteenth	énième
enigma	énigme
issue	enjeu
issues	enjeux
removed	enlevé
abduction	enlèvement
remove	enlever
illuminator	enlumineur
Snow	enneigement
boredom	ennui
bored	ennuie
boring	ennuyeux
states	énonce
enunciated	énoncé
Huge	énormes
investigation	enquête
Investigations	enquêtes
records	enregistre
recording	enregistrement
recordings	enregistrements
record	enregistrer
recorded	enregistrés
enriched	enrichie
taught	enseigna
teacher	enseignant
Teacher	Enseignant
teachers	enseignants
taught	enseigné
education	enseignement
lessons	enseignements
teach	enseigner
together	ensemble
Together	Ensemble
sunshine	ensoleillement
follows	ensuit
then	ensuite
Then	Ensuite
begins	entame
start	entamer
ente	ente
hear	entendre
hear	entends
heard	entendu
heard	entendus
agreement	entente
buried	enterrée
funeral	enterrement
bury	enterrer
buried	enterrés
enthusiastic	enthousiaste
whole	entier
whole	entière
entirely	entièrement
entity	entité
entourage	entourage
enclosures	entourages
surrounding	entourant
surrounded	entourée
Surrounded	Entourée
entered	entra
causes	entraine
causes	entraîne
Training	entrainement
training	entraînement
coach	entraineur
coach	entraîneur
Coach	Entraîneur
Incoming	entrant
between	entre
entered	entré
entry	entrée
entries	entrées
enter	entrent
stored	entreposées
undertake	entreprendre
contractor	entrepreneur
business	entreprise
Business	Entreprise
businesses	entreprises
Businesses	Entreprises
enter	entrer
maintain	entretenir
kept	entretenu
maintenance	entretien
conversed	entretint
Interviews	entrevues
invade	envahir
invasive	envahissant
invade	envahissent
envelopment	enveloppement
back	envers
envy	envie
about	environ
About	Environ
surrounding	environnante
surrounding	environnantes
environment	environnement
Environment	Environnement
considered	envisagée
consider	envisager
dispatch	envoi
sends	envoie
send	envoient
flights	envolées
envoy	envoyé
send	envoyer
enzymes	enzymes
eolian	éolien
wind	éolienne
eos	eos
EP	EP
EPA	EPA
thick	épais
thick	épaisse
thickness	épaisseur
thicknesses	épaisseurs
Spreading	épandage
scattered	éparpillées
wreck	épave
Spelt	épeautre
spicy	épicée
Epicure	Epicure
thorn	épine
thorny	épineux
pin	épingle
episode	épisode
sponge	éponge
eponym	éponyme
epic	épopée
time	époque
wife	épouse
marry	épouser
husband	époux
test	épreuve
hardship	épreuves
experienced	éprouvé
exhausted	épuisées
Ecuador	Équateur
Horse	équestres
team	équipe
equipped	équipé
equipment	équipement
teams	équipes
equitable	équitable
equity	équité
equivalent	équivalentes
equivalent	équivaut
st	er
eradicate	éradiquer
ergonomics	ergonomie
ergonomic	ergonomique
Erik	Erik
erosion	érosion
wandering	errant
wander	errer
error	erreur
wrong	erroné
Eritrea	Érythrée
es	es
Sc	ès
squadron	escadrille
climbing	escalade
climb	escalader
staircase	escalier
steep	escarpé
steep	escarpées
slave	esclave
Slaves	esclaves
fencing	escrime
fencer	escrimeur
space	espace
Spain	Espagne
Spanish	espagnol
Spanish	espagnole
species	espèce
Species	Espèce
hope	espérance
hopes	espère
hope	espérer
hope	espérons
espionage	espionnage
hope	espoir
Spirit	Esprit
sketches	esquisses
ESR	esr
test	essai
Test	Essai
trying	essayais
trying	essayant
tries	essaye
try	essayer
essentially	essentiellement
essential	essentielles
axle	essieu
towels	essuie
is	est
Is	Est
IS	EST
Esther	Esther
believing	estimant
estimate	estimation
valued	estimé
estimated	estimées
summery	estival
summer	estivale
Estonia	Estonie
Estonian	estonien
estuaries	estuaires
and	et
And	Et
AND	ET
established	établie
established	établis
establishment	établissement
establishes	établit
floor	étage
floors	étages
were	étaient
was	étais
was	était
watertight	étanche
Being	Etant
being	étant
step	étape
State	Etat
condition	état
Condition	État
State	étatique
States	Etats
States	États
etc.	etc
etc.	etc.
summer	été
Summer	Été
extinct	éteint
extends	étend
extend	étendent
expand	étendre
extended	étendus
Eternal	éternelle
eternal	éternelles
are	êtes
Are	Êtes
Ethan	Ethan
Ethernet	Ethernet
Ethiopia	Éthiopie
ethnic	ethnique
Etienne	Etienne
label	étiquette
labels	étiquettes
stretch	étirent
Etoile	Etoile
amazing	étonnante
surprised	étonné
strange	étrange
foreign	étranger
Foreign	étrangères
foreign	étrangers
Foreigners	Étrangers
strange	étranges
be	etre
be	être
beings	êtres
study	étude
Studies	Études
Students	Etudiants
students	étudiants
studying	étudie
studied	étudié
studied	étudiées
study	étudier
had	eu
EUR	EUR
Eure-et-Loir	Eure-et-Loir
had	eurent
Europcar	Europcar
Europe	Europe
European	européen
European	européenne
European	européens
euros	euros
Euros	Euros
Eurosport	Eurosport
Eurovision	Eurovision
them	eux
Them	Eux
themselves	eux-mêmes
Eva	Eva
Éva	Éva
evacuation	évacuation
assessment	évaluation
Evangelical	Évangélique
Evangelicals	évangéliques
escape	évasion
event	événement
range	éventail
events	events
eventuality	éventualité
eventually	éventuellement
potential	éventuels
bishop	évêque
Everywhere	Everywhere
obviously	évidemment
evidence	évidence
avoid	eviter
avoid	éviter
avoided	évités
evolves	évolue
evolution	évolution
Evolution	Évolution
evoking	évoquant
recalls	évoque
discussed	évoqué
evoke	évoquent
evoke	évoquer
ex	ex
exact	exact
correct	exacte
accuracy	exactitude
review	examen
exams	examens
examines	examine
examined	examiné
examine	examiner
exasperation	exaspération
exceeds	excède
excellent	excellent
Excellent	Excellent
excellent	excellente
excellent	excellents
exception	exception
exceptional	exceptionnel
excess	excès
excitement	excitation
excluded	exclu
exclude	exclure
exclusive	exclusif
exclusion	exclusion
Exclusion	Exclusion
exclusiveness	exclusivité
excuse	excuse
apology	excuses
performer	exécutant
performs	exécute
perform	exécutent
perform	exécuter
executed	exécutés
executive	exécutif
executive	executive
Executive	exécutive
copy	exemplaire
copies	exemplaires
example	exemple
Examples	Exemples
practicing	exerçant
exercise	exercer
exercise	exercice
epigraph	exergue
urging	exhortant
requires	exige
required	exigé
requirement	exigence
requirements	exigences
require	exigent
require	exiger
existed	existait
existing	existants
Available	Existe
existence	existence
exist	existent
exist	exister
exodus	exode
exemption	exonération
exemptions	exonérations
exotic	exotique
expansion	expansion
expatriation	expatriation
expatriates	expatriés
expectation	expectative
expedition	expédition
experiences	expériences
Experimental	expérimentale
experiments	expérimentations
expert	expert
expertises	expertises
Expert	experts
expiation	expiation
expire	expirera
explanations	explications
explains	explique
exploitation	exploitation
farms	exploitations
operates	exploite
exploring	explorant
Exploration	Exploration
explores	explore
explored	explorées
exploded	explosé
explosion	explosion
Explosive	explosives
exhibits	expose
exposed	exposé
exposed	exposées
exposure	exposition
expression	expression
expressions	expressions
deportee	expulsé
expel	expulser
exquisite	exquises
ecstatic	extatique
extension	extension
exterior	extérieur
Outdoor	extérieure
extinguishers	extincteurs
extra	extra
Extra	Extra
extract	extrait
aliens	extraterrestres
extremely	extrêmement
Extremely	Extrêmement
extreme	extrêmes
extremity	extrémité
F	F
Fabienne	Fabienne
Fabio	Fabio
fable	fable
manufacturer	fabricant
Manufacturers	fabricants
manufacturing	fabrication
Fabrice	Fabrice
factory	fabrique
made	fabriqué
manufactured	fabriquées
manufactured	fabriqués
fabulous	fabuleux
Fabulous	Fabulous
uni	fac
façade	façade
face	face
Facebook	Facebook
facets	facettes
easy	facile
easily	facilement
way	facon
way	façon
manners	façons
factor	facteur
factors	facteurs
dummy	factice
billing	facturation
bill	facture
bills	factures
faculty	faculté
Faculty	Faculté
bland	fade
FAF	FAF
low	faible
weakly	faiblement
weakness	faiblesse
break	faille
bankrupt	failli
bankruptcy	faillite
do	faire
Do	Faire
do	fais
feasibility	faisabilité
feasible	faisable
was	faisait
doing	faisant
beam	faisceau
Let	Faisons
fact	fait
Fact	Fait
made	faite
made	faites
cliff	falaise
Cliff	Falaise
Falkland	Falkland
Fall	Fall
needed	fallait
required	fallu
took	fallut
False	False
Famer	Famer
famous	fameuse
famous	fameux
family	famille
family	familles
Family	Family
fan	fan
Fan	Fan
fantasy	fantasme
fantasy	fantasy
FAQ	FAQ
Far	Far
flour	farine
wild	farouche
fiercely	farouchement
fascine	fascine
fascist	fasciste
fashion	fashion
do	fassent
pomp	faste
fatal	fatal
fatigue	fatigue
Tired	Fatigué
tire	fatiguer
Fau	Fau
suburb	faubourg
broke	fauché
will	faudra
should	faudrait
Wildlife	Faune
falsely	faussement
must	faut
Foul	Faute
armchair	fauteuil
tawny	fauve
false	faux
favorable	favorable
favorite	favori
favorites	favoris
promotes	favorise
fax	fax
FCFA	FCFA
starchy	féculent
federal	fédéral
congratulate	féliciter
Félix	Félix
female	femelle
women	féminins
woman	femme
Woman	Femme
women	femmes
split	fendu
Fenerbahçe	Fenerbahçe
window	fenêtre
windows	fenêtres
slot	fente
Iron	Fer
will	fera
will	ferai
would	ferait
will	ferez
farm	ferme
closed	fermée
Closed	Fermée
firmly	fermement
ferment	ferment
fermentation	fermentation
close	fermer
farms	fermes
Closed	fermés
Closing	Fermeture
farmer	fermier
Farmers	fermiers
Fernande	Fernande
fierce	féroce
scrap	ferraille
rail	ferré
ferry	ferry
fertility	fertilité
Fez	Fès
Festival	Festival
festivals	festivals
celebration	fête
fetishism	fétichisme
fire	feu
Fire	Feu
feud	feud
sheet	feuille
Leaves	Feuilles
serials	feuilletons
felt	feutre
lights	feux
Lights	Feux
February	février
February	Février
FG	FG
reliability	fiabilité
reliable	fiable
plug	fiche
sheets	fiches
file	fichier
fictive	fictif
fiction	fiction
fictive	fictive
fictitious	fictives
faithful	fidèle
Fiji	Fidji
proud	fier
proud	fiers
pride	fierté
Figaro	Figaro
featured	figurait
figure	figure
included	figurent
figure	figurer
Figures	figures
wire	fil
file	file
net	filet
netting	filets
filial	filial
subsidiary	filiale
spinneret	filière
girl	fille
Girl	Fille
Girls	Filles
godson	filleul
goddaughter	filleule
movie	film
filmed	filmé
filmed	filmés
movies	films
son	fils
Son	Fils
Filtering	filtrage
filter	filtre
filter	filtrer
filters	filtres
end	fin
End	Fin
final	finale
finally	finalement
Finally	Finalement
finality	finalité
funding	financement
finance	financer
finances	finances
Financial	financières
fine	fines
fineness	finesse
finished	fini
end	finir
ending	finissant
ends	finit
finishing	finition
Finland	Finlande
Firefly	Firefly
firm	firme
Firmware	Firmware
First	First
made	fis
tax	fiscale
tax	fiscales
Fisher	Fisher
made	fit
fitness	fitness
five	five
Fix	Fix
fixing	fixation
fixed	fixée
fix	fixent
fixed	fixés
FL	FL
flambé	flambé
blaze	flambée
flank	flanc
stroll	flâner
flanked	flanqué
flash	flash
Flash	Flash
arrow	flèche
arrows	flèches
flower	fleur
Flower	Fleur
flowery	fleurie
bloom	fleurir
flower	fleuris
flowers	fleurs
Flowers	Fleurs
river	fleuve
flexibility	flexibilité
Flexible	flexibles
flexion	flexion
Flipper	Flipper
flower	florales
flora	flore
Florent	Florent
fleet	flotte
blurred	flou
fluorescence	fluorescence
fluvial	fluvial
flow	flux
Fna	Fna
Foam	Foam
Focusing	focalisant
focused	focalisé
focus	focaliser
Foce	Foce
faith	foi
Faith	Foi
liver	foie
time	fois
madness	folie
folk	folk
folk	folklorique
folk	folkloriques
madwoman	folle
Madwoman	Folle
crazy	folles
darkens	fonce
dark	foncé
charge	foncer
landed	foncier
Property	foncière
function	fonction
Function	Fonction
official	fonctionnaire
functionality	fonctionnalité
features	fonctionnalités
working	fonctionnant
works	fonctionne
worked	fonctionné
functional	fonctionnel
run	fonctionner
functions	fonctions
background	fond
fundamental	fondamental
basically	fondamentalement
Foundation	Fondation
foundations	fondations
founded	fondé
fondues	fondues
are	font
fountain	fontaine
Fontenay-le-Comte	Fontenay-le-Comte
Food	food
football	foot
football	football
for	for
drilling	forage
force	force
forced	forcé
perforce	forcément
Forces	forces
Ford	Ford
Forestry	forestière
Forez	Forez
crime	forfait
format	format
formative	formateur
training	formation
Training	Formation
training	formations
shape	forme
Shape	Forme
formed	formé
form	forment
train	former
shapes	formes
wonderful	formidable
form	formulaire
formulation	formulation
formula	formule
formulated	formulé
fort	fort
strong	forte
strong	fortes
fortification	fortification
Fortified	fortifiée
fortune	fortune
forum	forum
Forum	Forum
crazy	fou
whip	fouet
searched	fouillée
excavation	fouilles
scarf	foulard
stride	foulée
crowds	foules
oven	four
Oven	Four
fork	fourchette
forked	fourchue
furnaces	fourneaux
provided	fourni
provided	fournie
Fournier	Fournier
provide	fournir
provided	fournis
provide	fournissent
provider	fournisseur
providers	fournisseurs
supply	fournissons
thicket	fourré
fur	fourrure
furs	fourrures
ovens	fours
crazy	fous
Fox	Fox
Foy	Foy
home	foyer
homes	foyers
EN	FR
Fra	Fra
fracture	fracture
fragile	fragile
fragile	fragiles
fragmentary	fragmentaires
fragmented	fragmentée
fragments	fragments
fresh	fraîche
fresh	fraiches
fresh	fraîches
fresh	frais
strawberry	fraise
raspberry	framboise
Fran	Fran
franc	franc
French	français
French	Français
French	française
French	françaises
French	Françaises
France	France
free	franche
honestly	franchement
Honestly	Franchement
crossed	franchi
Francine	Francine
Franck	Franck
François	François
Françoise	Françoise
francs	francs
Franks	Francs
Franklin	Franklin
striking	frappant
strike	frappe
hit	frappés
brotherhood	fraternité
Brotherhood	Fraternité
fraud	fraude
Frédéric	Frédéric
brake	frein
curb	freiner
brakes	freins
frequently	fréquemment
attendance	fréquentation
frequent	fréquente
Frequently	fréquentes
brother	frère
freight	fret
Freud	Freud
tidbit	friandise
Friday	Friday
friends	friends
Friends	Friends
fridge	frigo
frieze	frise
cold	froid
cold	froids
from	from
From	From
cheese	fromage
wheat	froment
Forehead	Front
border	frontière
fronts	fronts
friction	frottements
successful	fructueuses
successful	fructueux
FS	FS
fue	fue
fled	fui
flees	fuit
flight	fuite
Fukushima	Fukushima
lightning	fulgurant
Full	Full
smoke	fume
smoke	fumer
smoking	fumeur
smokers	fumeurs
smoke	fumez
funeral	funèbres
für	für
Fury	Furie
furious	furieux
Fuses	fusibles
gun	fusil
guns	fusils
fusion	fusion
was	fut
Fut	Fut
barrel	fût
futuristic	futuriste
Fuzhou	Fuzhou
g	g
G	G
G8	G8
template	gabarit
Gabon	Gabon
Gaby	Gaby
gachette	gachette
Gaga	Gaga
wages	gages
wins	gagne
Gagne	Gagne
won	gagné
Gagné	Gagné
earn	gagnent
win	gagner
earned	gagnés
Gago	Gago
gags	gags
gain	gain
Gal	Gal
galaxy	galaxie
galaxies	galaxies
galley	galère
gallery	galerie
Gallery	Galerie
galette	galette
galettes	galettes
Galilee	Galilée
Gall	Gall
Welsh	gallois
gallop	galop
galvanizes	galvanise
Gambia	Gambia
Gambia	Gambie
Game	Game
Glove	Gant
gloves	gants
Gaoussou	Gaoussou
Gar	Gar
garage	garage
Garage	Garage
garages	garages
guarantor	garant
warranty	garantie
boy	garçon
boys	garçons
garda	garda
kept	gardait
Gardanne	Gardanne
guard	garde
guarded	gardé
keep	gardent
keep	garder
guard	gardien
Guard	Gardien
guards	gardiens
roach	gardons
guy	gars
gasoil	gasoil
gastro	gastro
gastronomic	gastronomique
cake	gâteau
cakes	gâteaux
Gau	Gau
left	gauche
Left	Gauche
lefties	gauchers
stuff	gaver
gas	gaz
turf	gazon
giant	géant
gel	gel
frozen	gelé
jelly	gelée
embarrassing	gênant
gums	gencives
Gene	Gene
genealogy	généalogie
genealogical	généalogique
bother	gêner
General	General
general	général
General	Général
General	générale
usually	généralement
Usually	Généralement
General	générales
generalization	généralisation
widespread	généralisée
generator	générateur
generation	génération
General	généraux
generates	génère
generate	générer
generated	générés
generous	généreux
generic	générique
generic	génériques
Genesis	Genèse
Genevieve	Geneviève
great	génial
genius	génie
knee	genou
knee	genoux
genre	genre
people	gens
gent	gent
nice	gentil
kindness	gentillesse
gentleman	gentleman
geodesy	géodésie
geographer	géographe
geography	géographie
geographical	géographique
jails	geôles
geological	géologique
geometry	géométrie
geometric	géométrique
Georg	Georg
George	George
Georges	Georges
Georgia	Georgia
Georgia	Géorgie
manager	gérant
Gerard	Gérard
Gerardmer	Gérardmer
manages	gère
manage	gérer
Germain	germain
Germain	Germain
Germans	Germains
germinate	germer
gesture	geste
gestures	gestes
management	gestion
Geysers	geysers
Ghana	Ghana
gin	gin
Ginger	Ginger
girl	girl
Girl	Girl
lap	giron
deposit	gisement
home	gîte
Home	Gîte
houses	gîtes
Bed	Gîtes
gj	gj
ice	glace
Iced	Glacé
ice	glacées
glacier	glacier
Glaciers	glaciers
glands	glandes
slide	glissade
slips	glisse
slip	glissement
overall	global
Global	Globale
overall	globalement
globality	globalité
globe	globe
glorious	glorieux
GM	GM
Gmail	Gmail
Go	Go
Godard	Godard
Golden	Golden
golf	golf
gulf	golfe
Gulf	Golfe
Gonesse	Gonesse
swell	gonfler
Good	good
Good	Good
Google	Google
Gothic	gothique
gulf	gouffre
Gounelle	Gounelle
greedy	gourmands
taste	goût
governing	gouvernant
rulers	gouvernants
governs	gouverne
government	gouvernement
Government	Gouvernement
Government	gouvernementaux
GQ	GQ
grace	grâce
graceful	gracieux
ranking	gradé
Degrees	grades
gradient	gradient
graduated	gradue
gradually	graduellement
grains	grains
grease	graisse
Gram	gram
grammar	grammaire
Gran	Gran
great	grand
much	grand-chose
great	grande
greatly	grandement
greatness	grandeur
grandiose	grandiose
grow	grandir
growing	grandissant
grows	grandit
grandmother	grand-mère
grandfather	grand-père
great	grands
Great	Grands
graphic	graphique
Grasse	Grasse
fat	grasses
rewarding	gratifiant
Skyscraper	gratte-ciel
free	gratuit
Free	gratuite
Free	gratuits
serious	grave
Serious	Grave
serious	graves
climbed	gravi
Gravel	Gravier
gravitate	gravitent
Engraving	Gravure
Gray	Gray
Greece	Grèce
Greek	grecque
Greek	grecques
graft	greffe
clerk	greffier
grenade	grenade
Grenade	Grenade
frogs	grenouilles
Grenville	Grenville
strike	grève
Strike	Grève
grievance	grief
severely	grièvement
claws	griffes
Griffin	Griffin
grid	grille
Grilled	grillée
climb	grimper
flu	grippe
gray	gris
Gray	Gris
gray	grise
Greenland	Groenland
big	gros
Big	Gros
size	grosseur
enlarge	grossir
magnification	grossissement
wholesaler	grossiste
grotesques	grotesques
cave	grotte
Cave	Grotte
group	group
Group	Group
group	groupe
Group	Groupement
Groats	Gruau
logs	grumes
GTP	GTP
Guadeloupe	Guadeloupe
Guangdong	Guangdong
Guards	Guards
Guatemala	Guatemala
ford	gué
little	guère
guerrilla	guérilla
healing	guérisons
war	guerre
War	Guerre
Guerri	Guerri
Warriors	guerriers
watch	guet
mouth	gueule
mouths	gueules
Mistletoe	Gui
wicket	guichet
Wicket	Guichet
guide	guide
Guide	Guide
Guided	guidée
Guides	Guides
Guillaume	Guillaume
stilted	guindé
Guinea	Guinée
As	guise
guitarist	guitariste
Guru	Guru
taste	gustatives
Guy	Guy
Guyana	Guyana
guys	guys
gymnasium	gymnase
gymnastics	gymnastique
h	h
H	H
H2	H2
ha	ha
skill	habileté
habit	habit
inhabitant	habitant
people	habitants
habitat	habitat
habitats	habitats
lives	habite
inhabited	habité
live	habitent
live	habiter
clothes	habits
habit	habitude
usual	habituelle
usually	habituellement
hacker	hacker
hacking	hacking
Haguenau	Haguenau
hedges	haies
hatred	haine
hate	haïr
Haiti	Haïti
hall	hall
halle	halle
Halle	Halle
halt	halte
hamlet	hameau
Hamlet	Hamlet
shaft	hampe
han	han
Hanan	Hanan
hips	hanches
Handheld	Handheld
Disabled	handicapées
Disabled	handicapés
handicaps	handicaps
Hanoi	Hanoi
Hanoi	Hanoï
haunted	hanté
Hap	Hap
hard	hard
hardcore	hardcore
bean	haricot
Bean	Haricot
Harlem	Harlem
harmonic	harmonique
harp	harpe
Harry	Harry
chance	hasard
hast	hast
increase	hausse
top	haut
Top	Haut
haughty	hautaine
High	haute
High	Haute
High	hautes
height	hauteur
Height	Hauteur
heights	hauteurs
Mecca	haut-lieu
top	hauts
Tops	Hauts
Have	Have
haven	havre
Hawaii	Hawaï
Hawaii	Hawaii
Hawaiian	Hawaiian
He	He
Head	Head
Headline	Headline
Heart	Heart
heavy	heavy
Heavy	Heavy
Weekly	Hebdomadaire
Weekly	hebdomadaires
hosts	héberge
hosted	hébergé
accommodation	hébergement
Accommodation	Hébergement
hosting	hébergent
Hebrew	hébreu
Hector	Hector
Heidsieck	Heidsieck
Heinz	Heinz
Helen	Helen
Helena	Helena
Hélène	Hélène
propeller	hélice
helicopter	hélicoptère
Hell	Hell
Help	Help
hemisphere	hémisphère
hemorrhage	hémorragie
Henley	Henley
Her	Her
grass	herbe
Hercules	Hercule
hedgehog	hérisson
heritage	héritage
inherit	hériter
heir	héritier
heirs	héritiers
hermetic	hermétique
hernia	hernie
heroin	héroïne
heroic	héroïque
hero	héros
Herve	Herve
Hervé	Hervé
hesitant	hésitant
hesitation	hésitation
hesitate	hésite
hesitate	hésité
free	hésitez
Heterogeneous	hétérogènes
beech	hêtre
beeches	hêtres
time	heure
Time	Heure
hours	heures
happy	heureuse
fortunately	heureusement
happy	heureux
hits	heurte
hit	heurté
clashes	heurts
hexadecimal	hexadécimal
Hey	Hey
Hg	Hg
yesterday	hier
Yesterday	Hier
hierarchy	hiérarchie
high	high
High	High
Horse	hippique
Swallow	Hirondelle
His	His
history	histoire
History	Histoire
historian	historien
historic	historique
Historic	historiques
hit	hit
Hitler	Hitler
winter	hiver
Winter	Hiver
Ho	Ho
Holden	Holden
Holiday	Holiday
Holland	Holland
Dutch	hollandais
Dutch	hollandaises
Hollow	hollow
Hollywood	Hollywood
Home	Home
tribute	hommage
man	homme
men	hommes
Men	Hommes
counterpart	homologue
counterparts	homologues
Homophobia	homophobie
homosexual	homosexuel
Honda	Honda
Honduras	Honduras
Hong	Hong
Hungary	Hongrie
honest	honnête
honor	honneur
Honor	Honneur
Honor	Honor
fees	honoraires
honors	honore
honored	honoré
honor	honorer
shame	honte
shameful	honteux
hospital	hôpital
hospitals	hôpitaux
Hospitals	Hôpitaux
schedule	horaire
schedule	horaires
horizon	horizon
Except	Hormis
horoscope	horoscope
horror	horreur
except	hors
Except	Hors
Hortense	Hortense
Hospital	Hospitaliers
hospitalization	hospitalisation
hostile	hostile
hostile	hostiles
hostility	hostilité
breakfast	hote
host	hôte
hotel	hotel
Hotel	Hotel
Hoteliers	hôteliers
Hotels	Hotels
hotels	hôtels
Breakfast	hôtes
hostess	hôtesse
hotline	hotline
coal	houille
House	House
How	How
Hugh	Hugh
Hugo	Hugo
Hugues	Hugues
oil	huile
eight	huit
Eight	Huit
eighth	huitième
Oysters	huîtres
Hulk	Hulk
human	humain
Human	Humaine
humanism	humanisme
humanist	humaniste
Humanists	humanistes
humble	humbles
Hume	Hume
wet	humide
humiliating	humiliant
humiliate	humilier
humility	humilité
humorist	humoriste
humorous	humoristique
hydraulics	hydraulique
hydrolysis	hydrolyse
hydropneumatic	hydropneumatique
hygiene	hygiène
hypertension	hypertension
hypnosis	hypnose
hypocrite	hypocrite
Hypocrites	hypocrites
assumptions	hypothèses
i	i
I	I
Ian	Ian
Iberia	Ibérie
IBM	IBM
Icarus	Icare
here	ici
Here	Ici
iconographic	iconographique
id	id
IDC	IDC
Ideal	Ideal
ideal	idéal
idea	idée
Idea	Idée
idem	idem
Idem	Idem
identified	identifia
login	identifiant
identifies	identifie
identified	identifié
identify	identifier
identical	identique
identity	identité
suitable	idoine
iDTGV	iDTGV
ie	ie
If	If
IFM	IFM
unclear	ignore
ignore	ignorent
ignore	ignorer
II	II
it	il
It	Il
Ile	Ile
island	île
Island	Île
Ile-de-France	Île-de-France
Ill	Ill
illegal	illégale
illegally	illégalement
illegitimate	illégitime
unlimited	illimité
Illinois	Illinois
Illumination	Illumination
illusion	illusion
illusions	illusions
illusory	illusoire
showing	illustrant
illustrator	illustrateur
Illustrator	Illustrator
illustrator	illustratrice
illustrate	illustrer
island	ilot
islet	îlot
they	ils
They	Ils
Im	Im
Ima	Ima
imagery	imagerie
imagery	images
imaginary	imaginaire
imagine	imagine
imagine	imaginer
unbeatable	imbattable
imitate	imiter
immaterial	immatériel
immediate	immédiat
Immediate	immédiate
immediately	immédiatement
great	immense
immigration	immigration
immigrants	immigrés
immovable	immobilier
Immovable	Immobilier
Property	immobilières
property	immobiliers
immortal	immortel
immortals	immortels
unchangeable	immuable
immunity	immunité
Impact	Impact
Odd	impairs
imperfect	imparfait
impatient	impatient
impatient	impatiente
imperative	impératif
peremptory	impérative
imperfection	imperfection
Imperial	impériales
imperialism	impérialisme
relentless	implacable
implantable	implantable
implantation	implantation
implant	implanter
implicitly	implicitement
involving	impliquant
imply	impliquent
involved	impliqués
unpopular	impopulaire
importa	importa
importance	importance
important	important
important	importante
Important	importantes
important	importants
imports	importations
matter	importe
imposed	imposa
imposing	imposant
awesome	imposante
imposes	impose
imposed	imposé
compulsory	imposée
required	imposent
tax	impôt
Taxation	Impôts
impregnated	imprégné
impregnable	imprenable
printing	impression
awesome	impressionnant
awesome	impressionnante
impressed	impressionnée
impress	impressionner
unpredictable	imprévisible
printed	imprimées
print	imprimer
printers	imprimeurs
unfit	impropre
unexpectedly	improviste
impulsive	impulsif
pulse	impulsion
unpunished	impunis
in	in
In	In
Unacceptable	inacceptables
unfinished	inachevé
unfinished	inachevée
inactivated	inactivé
maladjusted	inadapté
inaugurated	inauguré
incantation	incantation
incapable	incapable
jailed	incarcéré
incarnates	incarne
ingrown	incarné
embody	incarnent
fire	incendie
uncertainty	incertitude
unchanged	inchangés
prompted	incita
encourages	incite
encourage	inciter
including	incluant
include	incluent
include	inclure
included	inclus
Included	Inclus
included	incluse
includes	inclut
Inconsistencies	incohérences
incompatibility	incompatibilité
incompetence	incompétence
incomprehension	incompréhension
unconditional	inconditionnel
unconditional	inconditionnelle
unknown	inconnu
unknown	inconnus
must	incontournable
Must	incontournables
disadvantage	inconvénient
drawbacks	inconvénients
incorporates	incorpore
mix	incorporer
incredible	incroyable
Incredible	Incroyable
incursion	incursion
India	Inde
undecided	indécis
unscathed	indemne
undeniable	indéniable
independently	indépendamment
independent	indépendant
Independent	Indépendant
index	index
Index	Index
India	India
indication	indication
Indications	indications
index	indice
Indices	indices
indie	indie
Indian	indien
Indian	indiens
indifferent	indifférent
native	indigènes
indignation	indignation
shows	indique
indicated	indiquée
indicate	indiquent
indicate	indiquer
indirect	indirect
indirectly	indirectement
indisputably	indiscutablement
indispensable	indispensable
unavailable	indisponible
individual	individu
single	individuel
single	individuelle
individually	individuellement
Individual	individuels
Indonesia	Indonésie
Indonesian	indonésien
indoor	indoor
induction	induction
Indus	Indus
industry	industrie
Industry	Industrie
Industrial	industrielle
Industrial	industrielles
novel	inédit
uneven	inégal
inexistent	inexistantes
inexistent	inexistants
lower	inférieur
inferiority	infériorité
infertility	infertilité
infiltrate	infiltrer
infinity	infini
infinite	infinie
infirm	infirmes
nurse	infirmier
Nurses	infirmières
Nursing	infirmiers
inflammation	inflammation
inflation	inflation
deals	inflige
affect	influe
influence	influencent
influential	influent
Influential	influentes
info	info
Info	Info
unfounded	infondées
informed	informa
information	information
news	informations
formless	informe
informed	informé
inform	informer
informed	informés
fruitless	infructueuses
engineering	ingénierie
engineer	ingénieur
engineers	ingénieurs
Ingenious	ingénieuse
ingenuity	ingéniosité
ingredients	ingrédients
inhalation	inhalation
inherent	inhérente
inherent	inhérentes
buried	inhumé
uninterrupted	ininterrompu
initial	initial
initial	initiale
initiation	initiation
initiation	initiatique
initiates	initie
initiate	initier
injunction	injonction
harmless	inoffensive
flooded	inondés
unforgettable	inoubliable
unheard	inouïs
worried	inquiet
worrying	inquiétant
worrying	inquiétante
worried	inquiète
worried	inquiètent
worry	inquiéter
Inquiry	Inquiry
registration	inscription
Registrations	inscriptions
enroll	inscrire
registered	inscrit
included	inscrite
included	inscrites
registered	inscrits
register	inscrivent
insect	insecte
insistence	insistance
insists	insiste
insist	insister
insist	insistez
unusual	insolite
inspection	inspection
inspiration	inspiration
inspires	inspire
inspired	inspirée
instability	instabilité
unstable	instable
Installation	Installation
amenities	installations
installs	installe
install	installer
settled	installèrent
authority	instance
Authority	Instance
bodies	instances
moment	instant
Instant	instantanée
instantly	instantanément
establishing	instauration
establish	instaurer
instigation	instigation
instinct	instinct
institute	institut
Institute	Institut
teacher	instituteur
institution	institution
Institutions	institutions
schoolmistress	institutrice
Institutes	Instituts
instruction	instruction
instrumentation	instrumentation
instruments	instruments
insufficiency	insuffisance
breathes	insuffle
island	insulaires
insulting	insultants
insults	insultes
insupportable	insupportable
intact	intacte
integrally	intégralement
integral	intégrante
Integration	Intégration
honest	intègre
integrate	intègrent
integrate	intégrer
integrated	intégrés
integrity	intégrité
Intel	Intel
Intelligence	Intelligence
intelligent	intelligent
intelligent	intelligente
intense	intense
intensive	intensif
intensively	intensivement
intentionally	intentionnellement
Inter	Inter
interaction	interaction
Interactive	interactives
interact	interagissent
intercept	intercepter
interception	interception
intercultural	interculturels
ban	interdire
prohibiting	interdisant
prohibited	interdite
Prohibited	interdits
interessa	interessa
interested	intéressa
interesting	intéressant
interesting	intéressante
interested	intéresse
interested	intéressée
interest	intéresser
interest	intérêt
interests	intérêts
interface	interface
inside	intérieur
Inside	Intérieur
Indoor	intérieure
Indoor	Intérieure
internally	intérieurement
Interior	intérieures
interim	intérim
interlocutor	interlocuteur
intermediate	intermédiaires
International	International
International	internationaux
user	internaute
internal	interne
intern	interner
internal	internes
Internet	internet
Internet	Internet
arrested	interpellé
interpellate	interpeller
interpretations	interprétations
interpreted	interprétée
interpret	interprètent
interpret	interpréter
perform	interprétera
interrogates	interroge
question	interroger
interrupted	interrompit
interrupt	interrompre
interruption	interruption
interruptions	interruptions
intersection	intersection
interstices	interstices
Intercity	interurbains
intervals	intervalles
players	intervenants
intervene	intervenir
intervention	intervention
interventionist	interventionniste
intervened	intervenus
interviews	interviews
close	intime
intimately	intimement
entitled	intitule
title	intitulé
entitled	intitulée
untouchables	intouchables
Untouchables	Intouchables
intrigue	intrigue
intrinsic	intrinsèque
introduction	introduction
Introduction	Introduction
introduced	introduit
intuition	intuition
Inuit	inuit
unnecessary	inutiles
invalid	invalide
invasion	invasion
invents	invente
invented	inventé
invented	inventée
invented	inventées
inventive	inventive
reverse	inverse
Reverse	inversé
conversely	inversement
reverse	inverser
inversion	inversion
Invested	Investi
invest	investir
investment	investissement
Investment	Investissement
investing	investissent
investor	investisseur
investiture	investiture
unbeaten	invincibilité
invisible	invisible
invitation	invitation
Invites	Invite
invited	invitée
invite	inviter
invoked	invoquée
incredible	invraisemblable
Io	Io
IP	IP
IPv6	IPv6
IR	IR
Iraq	Irak
Iran	Iran
Iranian	iranien
Iranian	iranienne
ire	ire
Irishwoman	irlandaise
Ireland	Irlande
Iron	Iron
irregular	irrégulier
Irregular	irrégulière
irreproachable	irréprochable
irruption	irruption
Isa	Isa
ISA	ISA
ISBN	ISBN
Islam	islam
Islamic	islamique
Islamists	islamistes
Island	Island
Iceland	Islande
Islands	Islands
Isle	Isle
ISO	ISO
insulates	isole
isolation	isolement
Isotopes	isotopes
Israel	Israël
Israeli	israélien
Israeli	israéliennes
from	issus
it	it
It	It
Italiano	Italiano
Italy	Italie
Italian	italien
Italian	Italien
Italian	italiennes
Italian	italiens
itinerary	itinéraire
routes	itinéraires
IV	IV
IX	IX
j	j
J	J
Jacob	Jacob
Jacqueline	Jacqueline
Yore	Jadis
jealousy	jalousie
jealous	jaloux
Jam	Jam
Jamaica	Jamaïque
never	jamais
legs	jambes
ham	jambon
James	James
January	Jan
Janet	Janet
January	janvier
Japan	Japan
Japan	Japon
Japanese	japonais
Japanese	Japonais
Japanese	japonaises
garden	jardin
Garden	Jardin
gardening	jardinage
Gardens	Jardins
Jason	Jason
yellow	jaune
Javel	Javel
javelin	javelot
Jaw	Jaw
Jay	Jay
JC	JC
AD	J.-C.
JD	JD
I	je
I	Je
John	Jean
Jean-François	Jean-François
Jean-Jacques	Jean-Jacques
Jean-Luc	Jean-Luc
Jean-Yves	Jean-Yves
Jeff	Jeff
Jenifer	Jenifer
Jerry	Jerry
Jersey	Jersey
Jessica	Jessica
JESU	JESU
Jesus	Jesus
jet	jet
Jet	Jet
threw	jeta
throwing	jetant
thrown	jeté
throws	jette
game	jeu
Game	Jeu
Thursday	jeudi
Thursday	Jeudi
young	jeune
Young	Jeune
youth	jeunes
Youth	Jeunes
youth	jeunesse
games	jeux
Games	Jeux
Jim	Jim
Jimmy	Jimmy
OJ	JO
jewelers	joailliers
Joan	Joan
Joanne	Joanne
Careers	Jobs
Joe	Joe
Johanna	Johanna
John	John
Johnny	Johnny
Johns	Johns
Johnson	Johnson
joy	joie
join	joignent
join	joindre
joint	joint
pretty	joli
pretty	jolie
pretty	jolis
junction	jonction
Jones	Jones
Jordan	Jordan
Jordan	Jordanie
Jordanian	jordanien
Joseph	Joseph
Josephine	Joséphine
Josiane	Josiane
playing	jouait
played	jouée
played	jouées
play	jouent
play	jouer
plaything	jouet
toys	jouets
player	joueur
Player	Joueur
enjoy	jouir
day	jour
Day	Jour
newspaper	journal
Newspaper	Journal
reporter	journaliste
journalists	journalistes
Day	Journée
days	journées
days	jours
Days	Jours
Jouve	Jouve
Joy	Joy
cheerful	joyeuse
merry	joyeux
JP	JP
Jr	Jr
Ju	Ju
Judaism	judaïsme
Judaea	Judée
court	judiciaires
sound	judicieuses
judge	juge
Judge	Juge
found	jugé
trial	jugement
judge	juger
trial	jugés
Jewish	juif
July	juillet
June	Juin
Stud	Jules
Julie	Julie
Julian	julien
Juliette	Juliette
Julio	Julio
twin	jumeau
twins	jumeaux
twin	jumelle
binoculars	jumelles
mare	jument
Jumpy	Jumpy
June	June
junior	junior
Junior	juniors
Juniors	Juniors
Jupiter	Jupiter
jurisdiction	juridiction
jurisprudence	jurisprudence
lawyer	juriste
juice	jus
up	jusqu'
Until	Jusqu'
Until	Jusque
Just	Just
right	juste
Right	Juste
exactly	justement
Justice	Justice
justiciary	justicier
justified	justifié
warrant	justifient
Justin	Justin
juicy	juteux
juxtaposition	juxtaposition
k	k
K	K
Kader	Kader
kami	kamis
Kane	Kane
Kang	Kang
Kanye	Kanye
Kaposvár	Kaposvár
Kara	Kara
karate	karaté
Karel	Karel
Karine	Karine
Shea	karité
kart	kart
Kathy	Kathy
Katy	Katy
Kaufman	Kaufman
Kayaker	kayakiste
Kazakh	kazakhe
Kazakhstan	Kazakhstan
kebab	kebab
Kei	Kei
Keith	Keith
Ken	Ken
Kenneth	Kenneth
Kentucky	Kentucky
Kenya	Kenya
kerosene	kérosène
ketchup	ketchup
Kevin	Kevin
kilometers	kilomètres
Mileage	kilométrique
Kim	Kim
King	King
Kingdom	Kingdom
Kinshasa	Kinshasa
Kiss	Kiss
Kitchener	Kitchener
kitsch	kitsch
km	km
Know	Know
Koh	Koh
Korea	Korea
Kosovo	Kosovo
Kuwait	Koweït
Kurdish	kurde
Kurdistan	Kurdistan
l	l
the	l'
L	L
L.	L.
The	L'
the	la
The	La
there	là
There	Là
Lab	Lab
labels	labels
laboratory	laboratoire
laboratories	laboratoires
laborious	laborieux
lake	lac
coward	lâche
released	lâchée
release	lâcher
cowardice	lâcheté
lakes	lacs
gap	lacune
Gaps	lacunes
Lagarde	Lagarde
homely	laide
wool	laine
Wool	Laine
woolly	laineux
leaving	laissant
leash	laisse
let	laissé
leave	laissent
leave	laisser
left	laissés
let	laissez
dairy	laiterie
Dairy	laitière
Dairy	laitiers
brass	laiton
tatters	lambeaux
dismally	lamentablement
blades	lames
roller	laminoir
lamp	lampe
Lamp	Lampe
LAN	LAN
Lana	Lana
Lanaudière	Lanaudière
Lance	Lance
launching	lancement
launch	lancer
land	land
Heath	Lande
Landes	Landes
Landing	Landing
Landmark	Landmark
Landry	Landry
Languedoc	Languedoc
Lannes	Lannes
lanterns	lanternes
Laos	Laos
rabbit	lapin
Rabbit	Lapin
lackey	laquais
which	laquelle
Lara	Lara
bacon	lard
wide	large
widely	largement
width	largeur
tear	larme
tears	larmes
Lars	Lars
Larvae	larves
weary	las
Weary	Las
laser	laser
Last	Last
Lasta	Lasta
latency	latence
side	latérales
Side	latéraux
Latin	latin
Laureates	Lauréats
laurel	laurier
Lausanne	Lausanne
washable	lavable
washbasin	lavabo
lavender	lavande
lava	lave
wash	laver
wash	lavis
law	law
laxity	laxisme
lazy	lazy
the	le
The	Le
THE	LE
leader	leader
Leader	Leader
leaders	leaders
Leave	Leave
Lebel	Lebel
reader	lecteur
Readers	lecteurs
reading	lecture
readings	lectures
Lee	Lee
legal	légal
Legal	légale
Legal	légales
legendary	légendaire
caption	légende
legends	légendes
slight	légère
slightly	légèrement
light	légers
legion	légion
legitimate	légitimes
legitimacy	légitimité
church	léglise
Legrand	Legrand
legacy	legs
Legumes	légumineuses
Leila	Leila
leitmotiv	leitmotiv
slow	lent
slow	lente
slowly	lentement
lens	lentille
lentils	lentilles
Léon	Léon
Leonard	Leonard
Leonardo	Leonardo
leopard	léopard
which	lequel
Leroy	Leroy
the	les
The	Les
Leslie	Leslie
which	lesquelles
which	lesquels
laundry	lessive
Lethal	létale
Leto	Leto
Lett	Lett
Latvia	Lettonie
letter	lettre
Letter	Lettre
letters	lettres
leukemia	leucémie
their	leur
their	leurs
rising	levant
lifts	lève
lifting	levée
lifted	levées
level	level
Yeast	levures
Lewis	Lewis
LG	LG
LH	LH
Li	Li
lia	lia
link	liaison
Liam	Liam
binder	liant
Lebanon	Liban
liber	liber
Liber	Liber
liberal	libéral
liberalization	libéralisation
releasing	libérant
liberals	libéraux
releases	libère
released	libéré
Freed	Libérée
freedoms	libertés
Books	libraire
bookstore	librairie
bookstores	librairies
free	libre
free	libres
Libya	Libye
Libyan	libyen
license	licence
Licenses	licences
termination	licenciement
licensees	licenciés
License	License
related	liée
related	liées
connections	liens
place	lieu
Place	Lieu
leagues	lieues
Places	lieux
line	ligne
Line	Ligne
line	lignée
lines	lignées
lines	lignes
league	ligue
League	Ligue
Lili	Lili
Lille	Lille
Lily	Lily
Limay	Limay
Limit	Limit
limit	limite
limited	limité
neighboring	limitrophe
Limousin	Limousin
limousine	limousine
Linen	Lin
Lincoln	Lincoln
Linda	Linda
line	line
lingerie	lingerie
linguistics	linguistique
Language	linguistiques
Linux	Linux
Lionel	Lionel
Liquefied	liquéfié
liqueur	liqueur
liquidate	liquider
read	lire
Read	Lire
lily	lis
read	lisait
LISBON	LISBONNE
Read	Lisez
edge	lisière
Lisieux	Lisieux
smooth	lissage
smooth	lisse
smooth	lisses
list	liste
List	Liste
Lists	listes
bed	lit
bedding	literie
literary	littéraire
Literary	littéraires
literally	littéralement
coastline	littoral
Littré	Littré
Lithuania	Lituanie
liturgy	liturgie
liturgical	liturgique
live	live
Live	Live
Living	Living
delivered	livra
delivery	livraison
book	livre
Book	Livre
delivered	livré
livery	livrée
delivered	livrées
deliver	livrent
deliver	livrer
books	livres
Books	Livres
delivered	livrés
booklets	livrets
local	local
Local	Local
Local	locale
local	locales
location	localisation
tenant	locataire
Tenants	locataires
Tenants	Locataires
renting	location
local	locaux
locomotives	locomotives
speaker	locuteur
Lodge	Lodge
Loft	Loft
lodge	loge
housing	logement
housing	logements
house	loger
Lodges	loges
loggia	loggia
Software	logiciels
logic	logique
dwelling	logis
logos	logos
law	loi
Law	Loi
far	loin
Far	Loin
distant	lointain
distant	lointaine
distant	lointaines
distant	lointains
Dormouse	Loir
Loire	Loire
leisure	loisir
Recreation	loisirs
Lola	Lola
London	London
London	londonien
London	Londres
long	long
tether	longe
along	longeant
long	longs
long	longtemps
long	longue
Long	Longue
long	longuement
long	longues
lengths	longueurs
Lorraine	Lorraine
then	lors
when	lorsqu'
When	Lorsqu'
when	lorsque
When	Lorsque
los	los
Lost	Lost
lot	lot
Lot	Lot
allotment	lotissement
Lotus	Lotus
rented	loua
praise	louanges
rented	loué
rent	louer
wolf	loup
heavy	lourdes
Leuven	Louvain
Louvre	Louvre
low	low
rent	loyer
rents	loyers
LP	LP
read	lu
Luc	Luc
Lucas	Lucas
lucid	lucide
Lucien	Lucien
Lucky	Lucky
ludic	ludique
read	lue
light	lueur
Lufthansa	Lufthansa
him	lui
Him	Lui
Luigi	Luigi
Luke	Luke
light	lumière
Light	Lumière
light	lumineuse
luminous	lumineux
Luna	Luna
lunar	lunaire
moody	lunatique
Monday	lundi
Monday	Lundi
moon	lune
Moon	Lune
glasses	lunettes
Read	lus
fighting	luttant
fight	lutte
Fight	Lutte
fight	lutter
strife	luttes
wrestler	lutteur
luxury	luxe
Luxembourg	Luxembourg
Luxembourg	luxembourgeoise
luxurious	luxueuse
luxurious	luxueux
Luzech	Luzech
schoolboy	lycéen
schoolgirl	lycéenne
students	lycéens
lynx	lynx
Lyon	Lyon
Lyon	lyonnais
lily	lys
Lys	Lys
m	m
M	M
Mr.	M.
M1	M1
m2	m2
my	ma
My	Ma
MA	MA
Mac	Mac
Macao	Macao
Macedonia	Macédoine
machination	machination
machine	machine
Machine	Machine
machinery	machines
jaw	mâchoire
Macon	Mâcon
mason	maçon
Madagascar	Madagascar
Mrs.	madame
Mrs.	Madame
made	made
miss	mademoiselle
Madoka	Madoka
Madrid	Madrid
mafia	mafia
store	magasin
Store	Magasin
stores	magasins
magazines	magazines
Mages	Mages
Maggie	Maggie
Maghreb	maghrébine
Maghreb	maghrébines
Maghreb	maghrébins
Magic	Magic
magic	magique
Magic	Magique
magistrate	magistrat
magma	magma
Magna	Magna
magnesium	magnésium
magnificence	magnificence
magnificent	magnifique
beautiful	magnifiques
magnitude	magnitude
Magnus	Magnus
Magyar	Magyar
May	mai
May	Mai
Maid	Maid
Email	mail
shirt	maillot
jerseys	maillots
hand	main
Hand	Main
hands	mains
maintenance	maintenance
now	maintenant
Now	Maintenant
maintain	maintenir
maintained	maintenu
maintained	maintenue
time	maintes
maintenance	maintien
maintain	maintiennent
maintains	maintient
mayor	maire
Mayor	Maire
but	mais
But	Mais
corn	maïs
Corn	Maïs
home	maison
Home	Maison
homes	maisons
master	maître
Master	Maître
mistress	maîtresse
mistresses	maîtresses
mastery	maîtrise
restrained	maîtrisé
master	maîtriser
majestic	majestueux
major	majeur
major	majeures
Staff	Major
increase	majoration
butler	majordome
mostly	majoritairement
majority	majorité
Mallorca	Majorque
majors	majors
uppercase	majuscules
evil	mal
Evil	Mal
sick	malade
sick	malades
disease	maladie
malaise	malaise
Malaysia	Malaisie
Malawi	Malawi
male	mâle
misunderstanding	malentendu
despite	malgré
woe	malheur
unfortunately	malheureusement
Unfortunately	Malheureusement
unfortunate	malheureux
dishonesty	malhonnêteté
Mali	Mali
MALI	MALI
Malicorne	Malicorne
trunk	malle
Maltese	maltais
Malta	Malte
mom	maman
granny	mamie
man	man
Man	Man
Mana	Mana
Manage	Manage
Management	Management
manager	manager
Manager	Manager
managers	managers
Manama	Manama
sleeve	manche
Sleeveless	manches
mandate	mandat
eat	mange
eaten	mangé
eating	mangeant
eaten	mangée
eat	manger
Eat	Manger
eaten	mangés
Mani	Mani
fashion	manière
manners	manières
protesters	manifestants
event	manifestation
events	manifestations
manifesto	manifeste
manifest	manifester
manigance	manigance
Manin	Manin
manipulation	manipulation
handle	manipuler
Mann	Mann
manna	manne
mannequin	mannequin
Manor	Manoir
missed	manqua
missing	manquait
missing	manquant
missing	manquants
lack	manque
miss	manquer
miss	manquerait
Mansa	Mansa
coat	manteau
manual	manuel
Manual	Manuel
manually	manuellement
manuals	manuels
handwritten	manuscrite
Maoist	maoïste
marsh	marais
slump	marasme
marble	marbre
marc	marc
Marcel	Marcel
merchant	marchand
market	marchande
goods	marchandises
march	marche
March	Marche
market	marché
walk	marcher
steps	marches
markets	marchés
Marco	Marco
Mard	Mard
Tuesday	mardi
Tuesday	Mardi
pond	mare
Marec	Marec
swamp	marécage
marshal	maréchal
margins	marges
husband	mari
Maria	Maria
María	María
marriage	mariage
Marian	Marian
Mary	marie
married	marié
married	mariée
Married	Mariée
married	mariées
marry	marier
Marina	Marina
navy	marine
marine	marines
marine	marins
Mario	Mario
Marius	Marius
Marly	Marly
compote	marmelade
Pot	Marmite
Marl	Marne
Morocco	Maroc
Moroccan	marocain
Moroccan	marocaine
Moroccan	Marocaine
Moroccan	marocains
brand	marque
marked	marquée
marked	marquées
mark	marquer
brands	marques
marked	marqués
Marquette	Marquette
marker	marqueur
godmother	marraine
tired	marre
brown	marron
March	mars
Marseille	marseillais
Marseille	Marseillais
Marseilles	Marseille
Marshall	Marshall
Martin	Martin
Martinique	Martinique
martyr	martyr
Marvel	Marvel
Marx	Marx
Mary	Mary
male	masculin
hide	masquer
masks	masques
massacre	massacre
massacre	massacrer
slaughtered	massacrés
massage	massage
massages	massages
mass	masse
massage	masser
masses	masses
massif	massif
massively	massivement
Massy	Massy
Master	master
Master	Master
Masters	Masters
matt	mat
mast	mât
match	match
Match	Match
matches	matches
matches	matchs
mattress	matelas
sailor	matelot
material	matériau
equipment	matériel
Hardware	matérielle
materials	matériels
maternal	maternel
Kindergarten	maternelle
mathematics	mathématiques
materials	matières
morning	matin
Matisse	Matisse
matrix	matrice
matrices	matrices
Regimental	matricule
mats	mats
Matt	Matt
matter	matter
Matthieu	Matthieu
Maurice	Maurice
Mauritius	mauricien
Mauritania	Mauritanie
Mauritania	mauritanienne
Mauritanian	mauritaniens
bad	mauvais
mauve	mauve
ill	maux
Max	maxi
Maxim	Maxime
Mayer	Mayer
Mayor	Mayor
Mayotte	Mayotte
me	me
Me	Me
ME	ME
Meat	Meat
Meaux	Meaux
mechanical	mécaniques
mechanism	mécanisme
sponsorship	mécénat
mecha	mecha
wickedness	méchanceté
naughty	méchante
unknown	méconnue
dissatisfied	mécontent
disaffected	mécontents
medal	médaille
medals	médailles
locket	médaillon
doctor	médecin
medicine	médecine
doctors	médecins
Media	Media
median	médiane
media	médias
Media	médiathèque
medical	médical
Medical	médicales
pharmaceuticals	médicaments
Medicare	Medicare
Medical	médicaux
Medieval	médiévale
mediocrity	médiocrité
Mediterranean	Méditerranée
Mediterranean	méditerranéen
Mediterranean	méditerranéens
jellyfish	méduse
meeting	meeting
distrust	méfiance
Mega	méga
Mehdi	Mehdi
Mehta	Mehta
best	meilleur
better	meilleure
best	meilleures
top	meilleurs
Mel	Mel
mixture	mélange
mixtures	mélanges
Melanie	Melanie
mixed	mêlé
melodies	mélodies
melodic	mélodique
Melody	Melody
melon	melon
Melrose	Melrose
membrane	membrane
Member	membres
meme	meme
even	même
Even	Même
same	mêmes
memoirs	mémoires
Memorial	Memorial
memorial	mémorial
Men	Men
mena	mena
threat	menace
Threatened	Menacé
threatened	menacée
threaten	menacent
threaten	menacer
household	ménage
spare	ménager
housewives	ménagères
households	ménages
leading	menant
Leading	Menant
begging	mendicité
leads	mène
conducted	menée
lead	mènent
lead	mener
menopause	ménopause
lying	mensonge
false	mensongère
lies	mensonges
menstruation	menstruations
monthly	mensuel
ment	ment
mental	mental
Liars	menteurs
mentioned	mentionnée
mention	mentionner
mentions	mentions
lie	mentir
chin	menton
menu	menu
carpentry	menuiserie
sea	mer
Sea	Mer
mercenary	mercenaire
Wednesday	mercredi
mercury	mercure
Fuck	merde
mother	mère
mothers	mères
merguez	merguez
meridional	méridional
Southern	méridionale
merite	merite
merit	mérite
deserve	méritent
seas	mers
Seas	Mers
wonder	merveille
wonderful	merveilleux
my	mes
My	Mes
Mesa	Mesa
message	message
Posts	messages
mass	messe
Mass	Messe
messiah	messie
measure	mesure
measured	mesurée
measure	mesurer
steps	mesures
places	met
Met	Met
MET	MET
metallic	métallique
metal	métalliques
metaphor	métaphore
weather	météo
meteorology	météorologie
weather	météorologiques
methods	méthodes
craft	métier
Professions	Métiers
crossbreeding	métissage
metonymy	métonymie
footage	métrage
meter	mètre
meters	metres
meters	mètres
Metro	Métro
metropolis	métropole
Metropolis	Métropole
Metropolitan	métropolitaine
dish	mets
put	mette
director	metteur
put	mettez
will	mettra
put	mettre
dies	meurt
murder	meurtre
bruised	meurtri
murderer	meurtrier
Mexican	mexicain
Mexico	Mexico
Mexico	Mexique
Mey	Mey
mezza	mezza
MH	MH
mi	mi
Michael	Michael
Michaël	Michaël
Michel	Michel
Michèle	Michèle
mike	micro
Microbes	microbes
micrometer	micromètre
Micronesia	Micronésie
noon	midi
Noon	Midi
honey	miel
crumbs	miettes
better	mieux
Mighty	Mighty
migration	migration
migration	migratoires
migrates	migre
mil	mil
Kite	Milan
miles	miles
militia	milice
middle	milieu
military	militaire
Military	Militaire
militates	milite
milkshakes	milkshakes
thousand	mille
Miles	Milles
vintage	millésime
billion	milliard
Billionaire	milliardaire
thousand	millier
thousands	milliers
millimeters	millimètres
million	million
Millions	Millions
min	min
Min	Min
thin	mince
Mindscape	Mindscape
mine	mine
mineral	minéral
minerals	minéraux
minor	mineur
minor	mineures
Minors	mineurs
mini	mini
minibus	minibus
mining	minières
mining	miniers
minimal	minimal
minimum	minimale
Minimalist	minimaliste
minimalists	minimalistes
minimize	minimiser
minimum	minimum
minimum	minimums
ministry	ministère
Ministry	Ministère
minister	ministre
minivan	minivan
minority	minorité
Minorities	minorités
midnight	minuit
Midnight	Minuit
tiny	minuscule
minute	minute
minutes	minutes
Careful	minutieuse
Mirabeau	Mirabeau
miracles	miracles
mirror	miroir
Mirror	Miroir
placed	mis
Placed	Mis
misery	misère
missiles	missiles
Assignments	missions
Missions	Missions
moths	mites
shabby	miteux
mix	mix
mixed	mixte
ml	ml
mm	mm
MM	MM
Mrs.	Mme
mn	mn
Mo	Mo
mobile	mobile
Mobile	Mobile
mobile	mobiles
furniture	mobilier
mobilization	mobilisation
mobilize	mobiliser
mobility	mobilité
Mod	Mod
fashion	mode
Fashion	Mode
Model	Model
model	modèle
models	modèles
modem	modem
modems	modems
moderator	modérateur
moderation	modération
moderate	modéré
Moderate	modérée
moderate	modérés
Modern	Modern
modern	moderne
modern	modernes
modernization	modernisation
modernises	modernise
modernized	modernisée
modernize	moderniser
modes	modes
modestly	modestement
Modiano	Modiano
modification	modification
modifies	modifie
modified	modifié
change	modifier
modified	modifiés
modest	modique
modular	modulables
modulation	modulation
marrow	moelle
mellowness	moelleux
Mohamed	Mohamed
Mohammedia	Mohammedia
I	moi
I	Moi
myself	moi-même
monk	moine
Moines	Moines
less	moins
month	mois
Harvest	moissons
half	moitié
Moldova	Moldavie
time	moment
times	moments
my	mon
My	Mon
Monaco	Monaco
monarchy	monarchie
Monarchy	Monarchie
world	monde
worlds	mondes
World	Mondiale
World	mondiales
Money	monétaires
Money	Money
Mongolian	mongol
Mongolian	mongole
Mongolia	Mongolie
monitor	moniteur
monitors	moniteurs
Monk	Monk
currency	monnaie
Monogram	Monogram
Mons	Mons
gentleman	monsieur
Mr.	Monsieur
monster	monstre
Monster	Monstre
monsters	monstres
mount	mont
Mount	Mont
rose	monta
mounting	montage
mountain	montagne
mountains	montagnes
mountainous	montagneux
Montagny	Montagny
amount	montant
rising	montante
Amounts	montants
riding	monte
Riding	Monte
mounted	monté
rise	montée
Rise	Montée
rise	montent
mount	monter
Montérégie	Montérégie
mounted	montés
Montmartre	Montmartre
showed	montrait
showing	montrant
watch	montre
shown	montré
Montreal	Montréal
shown	montrées
show	montrent
show	montrer
watches	montres
mounts	montures
Moon	Moon
fun	moquait
mock	moquer
moral	moral
morals	morale
morals	morales
piece	morceau
parts	morceaux
bite	mordre
more	more
Morgan	Morgan
Morlaix	Morlaix
Morning	Morning
death	mort
Death	Mort
mortal	mortel
deadly	mortelle
cod	morue
mosaic	mosaïque
mosque	mosquée
Moss	Moss
word	mot
Word	Mot
biker	motard
engine	moteur
Mother	Mother
grounds	motifs
motivated	motivés
Motor	Motor
Motorised	motorisée
Motorola	Motorola
motorcycles	motos
keywords	mots-clés
soft	mou
handkerchief	mouchoir
grind	moudre
mooring	mouillage
wet	mouillé
castings	moulages
mill	moulin
Mill	Moulin
mills	moulins
moult	moult
Mountain	Mountain
Mourinho	Mourinho
die	mourir
pimpernel	mouron
die	mourront
foam	mousse
sparkling	mousseux
screen	moustiquaire
must	moût
sheep	mouton
milling	mouture
motion	mouvement
Motion	Mouvement
Movie	Movie
means	moyen
Means	Moyen
through	moyennant
means	moyens
Mr	Mr
M'sieur	M'sieur
mu	mu
moult	mue
mute	muets
Mulhouse	Mulhouse
Multichannel	multicanal
multimedia	multimédia
multiple	multiple
multiple	multiples
multiplex	multiplex
multiplied	multiplié
multiply	multiplier
Mumbai	Mumbai
provided	muni
Municipal	municipales
municipalities	municipalités
Municipal	municipaux
provided	munis
wall	mur
wall	muraux
Muriel	Muriel
mature	mûrissent
Murphy	Murphy
walls	murs
Walls	Murs
musk	musc
Muscadet	muscadet
muscular	musculaire
Muse	Muse
snout	museau
Museum	Musée
museums	musées
music	music
music	musical
musicology	musicologie
music	musique
Music	Musique
music	musiques
must	must
Muslim	musulman
Muslim	musulmane
Mutations	mutations
Mutual	mutuelle
my	my
Myanmar	Myanmar
spawn	mycélium
mysteries	mystères
mysterious	mystérieux
mystical	mystique
mythical	mythique
mythomane	mythomane
n	n
No.	n°
N	N
Nabucco	Nabucco
Nada	Nada
Nadine	Nadine
Nadu	Nadu
artless	naïf
Dwarfs	nains
birth	naissance
births	naissances
nascent	naissant
born	naissent
born	naît
naivety	naïveté
Namibia	Namibie
Namur	Namur
Nantes	Nantes
Não	Não
Napoleonic	napoléoniens
tablecloth	nappe
narrator	narrateur
narrow	narrow
native	natal
swimming	natation
Nathan	Nathan
native	natifs
nation	nation
national	national
National	National
National	nationale
nationality	nationalité
Nationalities	nationalités
nations	nations
nature	nature
Nature	Nature
Nau	Nau
shipwreck	naufrage
Nauru	Nauru
foul	nauséabondes
nautical	nautique
Naval	Naval
Naval	navales
Navarre	Navarre
turnip	navet
turnips	navets
shuttle	navette
Shuttles	navettes
navigator	navigateur
navigation	navigation
sailing	navigue
ship	navire
heartbreaking	navrant
Navy	Navy
Nazi	nazi
Nazis	nazis
not	ne
Not	Ne
born	né
However	Néanmoins
nothingness	néant
necessary	nécessaire
requiring	nécessitant
need	nécessité
nectar	nectar
nee	née
Dutch	néerlandais
Dutch	Néerlandais
born	nées
nave	nef
naves	nefs
negative	négatif
negligible	négligeable
neglect	négliger
negotiated	négocia
negotiable	négociable
negotiation	négociation
talks	négociations
negotiate	négocier
snow	neige
Neil	Neil
Neptune	Neptune
Nerve	nerveuse
nervous	nerveux
net	net
Netherlands	Netherlands
clear	nette
clearly	nettement
cleaned	nettoyée
clean	nettoyer
cleaned	nettoyés
nine	neuf
Nine	Neuf
neutralization	neutralisation
neutral	neutre
ninth	neuvième
Nevada	Nevada
Never	Never
Nevers	Nevers
new	new
News	News
NEWS	NEWS
Next	Next
Nexus	Nexus
nose	nez
or	ni
Or	Ni
Nicaragua	Nicaragua
Nicéphore	Nicéphore
niche	niche
nestled	niché
Nicobar	Nicobar
Nicolas	Nicolas
Nicole	Nicole
nest	nid
Nests	nids
denies	nie
niece	nièce
Nielsen	Nielsen
Niger	Niger
Nigeria	Nigeria
Nigeria	Nigéria
night	night
Nîmes	Nîmes
Nintendo	Nintendo
nis	nis
Niu	Niu
level	niveau
nj	nj
nm	nm
No.	no
No.	No
NO	NO
noble	noble
Nobility	Noblesse
wedding	noces
nocturne	nocturne
night	nocturnes
Noah	Noé
Christmas	noël
Christmas	Noël
knots	noeuds
black	noir
black	noire
Black	Noire
black	noires
black	noirs
Black	Noirs
nuts	noix
Nokia	Nokia
Nolan	Nolan
name	nom
Name	Nom
number	nombre
Number	Nombre
numbers	nombres
large	nombreuse
many	nombreuses
Many	Nombreuses
many	nombreux
Many	Nombreux
Nominal	nominale
Nominees	nominés
called	nomme
Appointed	Nommé
call	nomment
appointed	nommés
names	noms
not	non
Not	Non
NO	NON
nonchalance	nonchalance
none	none
North	nord
North	Nord
par	normale
normally	normalement
Normally	Normalement
normal	normales
standardized	normalisés
Norman	normand
standard	norme
standards	normes
North	North
Norway	Norvège
Norwegian	norvégien
our	nos
Our	Nos
notable	notable
Notable	notables
especially	notamment
Note	note
Note	Note
Notes	notes
Notes	Notes
notice	notice
notices	notices
notorious	notoires
Note	Notons
notoriety	notoriété
our	notre
Our	Notre
knots	noue
tie	nouer
fed	nourri
feed	nourrir
food	nourriture
us	nous
Us	Nous
new	nouveau
New	Nouveau
latest	nouveautés
new	nouveaux
new	nouvel
news	nouvelle
News	Nouvelle
newly	nouvellement
news	nouvelles
News	Nouvelles
November	nov
Nova	Nova
innovative	novateur
flooded	noyé
NPO	NPO
naked	nu
nuance	nuance
nuance	nuancer
naked	nue
skies	nues
harm	nuire
nuisances	nuisances
night	nuit
Night	Nuit
night	nuitée
nights	nuits
null	nul
Null	Nul
null	nulle
nothing	nullement
null	nuls
digital	numérique
Scanning	numérisation
number	numéro
numbers	numéros
nunavik	nunavik
Nunc	Nunc
nape	nuque
naked	nus
Nyon	Nyon
O	O
O	Ô
oasis	oasis
Obama	Obama
persuasions	obédiences
obey	obéir
obese	obèse
goal	objectif
goals	objectifs
objective	objective
object	objet
items	objets
Noble	Oble
compulsory	obligatoire
inevitably	obligatoirement
Compulsory	obligatoires
forced	obligé
forced	obligés
oblique	obliques
obscurity	obscurité
funeral	obsèques
watching	observant
observations	observations
observed	observé
watch	observer
obstacle	obstacle
obstinate	obstiné
obstruct	obstruer
get	obtenir
obtaining	obtention
obtained	obtenu
obtained	obtenue
obtained	obtenues
get	obtiendra
get	obtiendrez
get	obtiennent
gets	obtient
shell	obus
occasion	occasion
occasional	occasionnel
occasionally	occasionnellement
opportunities	occasions
Western	occidentale
Western	occidentaux
Westerners	Occidentaux
Occult	occultes
occupied	occupa
occupation	occupation
occupies	occupe
busy	occupé
occupy	occupent
oceanic	océanique
OCL	OCL
October	octobre
October	Octobre
granted	octroyé
Odeon	Odéon
smell	odeur
odors	odeurs
Odile	Odile
eye	oeil
egg	oeuf
Egg	Oeuf
egg	œuf
eggs	œufs
work	oeuvre
Work	Œuvre
works	œuvres
of	of
Of	Of
offensive	offensives
offered	offerte
office	office
offices	offices
officia	officia
formalizes	officialise
celebrant	officiant
official	officiel
official	officielles
official	officiels
officer	officier
offering	offrande
bidder	offrant
offer	offre
Offers	offres
offer	offrir
og	og
Oh	Oh
goose	oie
onion	oignon
onions	oignons
Oise	Oise
bird	oiseau
Bird	Oiseau
fowl	oiseaux
Ok	Ok
Old	Old
olives	olives
Olive	Olivier
Olympic	olympique
Olympic	olympiques
Oman	Oman
touchy	ombrageux
shadow	ombre
omitted	omis
omnipresent	omniprésent
WHO	OMS
one	on
One	On
uncle	oncle
Uncle	Oncle
wave	onde
Microwave	ondes
undulate	onduler
one	one
nails	ongles
dream	onirique
online	online
Online	Online
onm	onm
have	ont
Have	Ont
UN	ONU
opaque	opaque
Open	Open
OpenOffice	OpenOffice
opera	opera
operating	opérant
operator	opérateur
operational	opérationnelle
ophthalmology	ophtalmologie
ophthalmologist	ophtalmologue
opinion	opinion
opinions	opinions
Opioids	opioïdes
opium	opium
timeliness	opportunité
opponents	opposants
opposes	oppose
opposite	opposée
oppose	opposer
opposition	opposition
oppression	oppression
Optician	Opticien
Optimal	optimal
optimize	optimiser
option	option
Optical	optiques
gold	or
Oracle	Oracle
storm	orage
storms	orages
orange	orange
orange	orangé
Oratorical	Oratoire
Orchestra	Orchestre
ordinary	ordinaire
computer	ordinateur
computers	ordinateurs
prescription	ordonnance
order	ordre
garbage	ordures
ear	oreille
ears	oreilles
right	ores
plate	orfèvrerie
bodies	organes
organized	organisa
organizing	organisant
organizer	organisateur
organization	organisation
Organization	Organisation
organizations	organisations
organizes	organise
organized	organisé
organized	organisée
organize	organiser
organize	organisera
body	organisme
agencies	organismes
organ	orgue
pride	orgueil
East	Orient
guide	orienter
hole	orifice
original	original
Original	originales
original	originaux
Origins	origines
Origins	Origines
adorns	orne
decorated	orné
trappings	ornements
ornamented	ornés
toe	orteil
Orthodox	orthodoxes
spelling	orthographe
CSO	OSC
oscillation	oscillation
bone	osseuse
Ottawa	Ottawa
ottoman	ottomane
or	ou
Or	Ou
where	où
Where	Où
oblivion	oubli
forget	oublie
forgotten	oublié
forget	oublier
Uganda	Ouganda
yes	oui
Yes	Oui
Oum	Oum
Out	Out
tool	outil
tools	outillages
tools	outils
besides	outre
Besides	Outre
open	ouvert
Open	Ouvert
open	ouverte
open	ouverts
opening	ouverture
overtures	ouvertures
Structures	ouvrages
opens	ouvre
Opens	Ouvre
open	ouvrent
workers	ouvriers
open	ouvrir
opened	ouvrit
Oval	Oval
oval	ovales
over	over
Ovid	Ovide
p	p
P	P
P.	P.
pa	pa
Pasha	Pacha
Pacific	Pacific
pack	pack
page	page
Page	Page
pages	pages
payroll	paie
Payments	paiements
bread	pain
Bread	Pain
breads	pains
peer	pair
pair	paire
pairs	paires
Pais	Pais
Pakistan	Pakistan
Pala	Pala
palace	palais
Palace	Palais
Palau	Palaos
Palestinian	palestinien
Palestinian	palestinienne
Palmer	Palmer
Palmyra	Palmyre
lampoon	pamphlet
pamphlets	pamphlets
PAN	PAN
Panama	Panama
basket	panier
panic	panique
panel	panneau
paneling	panneaux
panoply	panoplie
trousers	pantalon
PAO	PAO
dad	papa
pope	pape
Pope	Pape
paper	papier
buds	papilles
Easter	Pâques
Packages	paquets
by	par
By	Par
parable	parabole
parachutist	parachutiste
Parachute	parachutistes
paradise	paradis
Paradise	Paradis
heavenly	paradisiaque
paradoxically	paradoxalement
section	paragraphe
Paraguay	Paraguay
appear	paraître
paralyzes	paralyse
Settings	paramètres
parasites	parasites
park	parc
Park	Parc
because	parce
Because	Parce
cover	parcourir
route	parcours
travels	parcourt
browsed	parcourus
parks	parcs
underneath	par-dessous
Above	par-dessus
Pardo	Pardo
forgiveness	pardon
Paré	Paré
windshield	pare-brise
decked	parée
such	pareille
Relative	Parent
relationship	parenté
parentheses	parenthèses
parents	parents
lazy	paresseux
perfect	parfaire
perfect	parfait
Perfect	Parfait
perfect	parfaite
Perfect	Parfaite
perfectly	parfaitement
perfect	parfaites
sometimes	parfois
Sometimes	Parfois
perfume	parfum
perfumes	parfums
Paris	paris
Parisian	parisien
Paris	parisienne
Paris	parisiens
parking	parking
spoke	parlaient
spoke	parlait
speaking	parlant
Speaking	Parlant
parliament	parlement
parliamentary	parlementaire
speak	parlent
speak	parler
talk	parlez
Parma	Parme
among	parmi
Among	Parmi
wall	paroi
speech	parole
words	paroles
godfather	parrain
share	part
sharing	partage
shared	partagé
shared	partageait
share	partagent
share	partager
Shared	partagés
thus	partant
partners	partenaires
partnership	partenariat
Partnerships	partenariats
leave	partent
leave	partez
party	parti
Party	Parti
participated	participa
participant	participant
participatory	participatif
participation	participation
interests	participations
participle	participe
participate	participent
participate	participer
feature	particularité
Feature	Particularité
particularities	particularités
particular	particulier
particularly	particulièrement
part	partie
partial	partielle
partially	partiellement
Partial	partiels
parts	parties
Parts	Parties
leave	partir
parties	partis
supporter	partisan
supporters	partisans
set	partit
partition	partition
scores	partitions
everywhere	partout
Everywhere	Partout
parts	parts
Party	Party
published	paru
published	parue
appeared	parut
release	parution
reach	parvenir
succeed	parviendra
reach	parviennent
arrives	parvient
managed	parvint
not	pas
Not	Pas
Pas-de-Calais	Pas-de-Calais
Pass	Pass
passed	passa
Passa	Passa
passage	passage
transient	passagère
passengers	passagers
passages	passages
going	passait
from	passant
pass	passe
Pass	Passe
past	passé
past	passée
past	passées
pass	passent
pass	passer
will	passera
Gateways	passerelles
passes	passes
past	passés
skip	passez
Spend	Passez
Liabilities	passifs
passing	passing
passion	passion
excited	passionnent
Pastel	Pastel
Pastor	Pasteur
pastoral	pastorale
Stalemate	Pat
Pate	Pate
dough	pâte
paste	pâté
paternal	paternel
paternal	paternelle
pasta	pates
Pathé	Pathé
Pati	Pati
patience	patience
patient	patient
Patient	Patient
patient	patiente
patients	patients
skating	patinage
patio	patio
pastry	pâtisserie
Patrick	Patrick
country	patrie
Country	Patrie
heritage	patrimoine
Heritage	Patrimoine
patriot	patriote
boss	patron
landlady	patronne
bosses	patrons
patrol	patrouille
legs	pattes
Pattinson	Pattinson
pastures	pâturages
Pau	Pau
Paul	Paul
palm	paume
Palm	Paume
pause	pause
poor	pauvre
poor	pauvres
poverty	pauvreté
Poverty	Pauvreté
pavement	pavé
pavilion	pavillon
Pavilion	Pavillon
poppy	pavot
paying	payant
Payable	payants
pay	paye
pay	payer
paid	payés
PayPal	PayPal
country	pays
Country	Pays
landscape	paysage
scenery	paysages
Landscape	paysagiste
peasantry	paysans
Netherlands	Pays-Bas
Paz	Paz
PCI	PCI
CEO	PDG
fishing	pêche
sins	péchés
fisherman	pêcheur
fishermen	pêcheurs
pedagogy	pédagogie
educational	pédagogique
pedophile	pédophile
paint	peindre
sentence	peine
painted	peints
paintings	peintures
pilgrim	pèlerin
Pilgrims	pèlerins
film	pellicule
lawn	pelouse
plush	peluche
penal	pénal
fondness	penchant
looks	penche
leaning	penché
for	pendant
pending	pendantes
pendant	pendants
hanged	pendu
pendulum	pendule
penetrates	pénètre
peninsula	péninsule
thinking	pensant
think	pense
thoughts	pensées
think	pensent
think	penser
thinker	penseur
think	pensez
Think	Pensez
pension	pension
pensions	pensions
thoughtful	pensive
slope	pente
Pentecost	pentecôte
Pentecost	Pentecôte
Pentium	Pentium
people	people
People	People
nurseries	pépinières
peplum	peplum
peptides	peptides
noticeable	perceptible
drill	percer
perch	perche
Percheron	percheron
perceived	perçues
ram	percuter
loses	perd
lost	perdait
loser	perdant
Losers	perdants
lose	perdent
lost	perdit
lose	perdre
lost	perdu
Perdue	Perdue
continues	perdure
father	père
Father	Père
Peres	Peres
Perfect	Perfect
perfection	perfection
improve	perfectionner
performance	performance
performance	performant
drip	perfusion
Permafrost	pergélisol
peri	péri
period	période
periodically	périodiquement
Devices	périphériques
Perl	Perl
pearl	perle
Pearl	Perle
permanence	permanence
Permanence	Permanence
allows	permet
allow	permettre
allowed	permis
allowed	permise
permission	permission
Peru	Pérou
Perpetual	Perpetual
perpetual	perpétuelle
perplexed	perplexe
search	perquisition
parrot	perroquet
parrots	perroquets
wig	perruque
Persian	persan
persecuted	persécuté
persecuted	persécutés
parsley	persil
Parsley	Persil
Persian	Persique
Persistent	persistants
persists	persiste
persist	persistent
Person	Person
character	personnage
characters	personnages
personalization	personnalisation
personalize	personnaliser
personalities	personnalités
person	personne
staff	personnel
Personal	personnelle
personally	personnellement
Personal	personnelles
Personal	personnels
people	personnes
perspective	perspective
persuades	persuade
convinced	persuadé
persuade	persuader
persuasive	persuasive
losses	pertes
pertinently	pertinemment
relevant	pertinentes
relevant	pertinents
disruption	perturbation
disturbed	perturbé
disturb	perturber
Peruvian	péruvien
weighs	pèse
weigh	peser
pesticides	pesticides
peta	peta
Pete	Pete
Peter	Peter
little	petit
Little	Petit
breakfast	petit-déjeuner
little	petite
Petite	Petite
petition	pétition
small	petits
Petre	Petre
tanker	pétrolier
oil	pétroliers
Petunia	Pétunia
little	peu
Little	Peu
populating	peuplant
people	peuple
populate	peuplent
Peoples	peuples
fear	peur
can	peut
Can	Peut
maybe	peut-être
Maybe	Peut-être
can	peuvent
can	peux
PH	PH
phalanges	phalanges
lighthouse	phare
highlight	phares
Pharma	Pharma
pharmacist	pharmacien
phase	phase
phenomenon	phénomène
Phi	Phi
philately	philatélie
Philip	Philip
Philippe	Philippe
Philippines	Philippines
philosopher	philosophe
philosophical	philosophique
Philosophy	Philosophy
Phone	Phone
seals	phoques
phosphate	phosphate
phosphorus	phosphore
photo	photo
Photo	Photo
photographer	photographe
Photographer	Photographe
photography	photographie
photographs	photographies
Photoshop	Photoshop
sentence	phrase
physical	physique
Physical	Physique
physically	physiquement
Physical	physiques
Piaf	Piaf
pianist	pianiste
piano	piano
peak	pic
Picardie	Picardie
pitcher	pichet
Pictorial	picturale
Magpie	Pie
play	pièce
coins	pièces
foot	pied
Foot	Pied
trap	piège
Pier	Pier
piercing	piercing
stone	pierre
Stone	Pierre
trample	piétinent
pedestrian	piéton
poor	piètre
Pious	Pieux
Pigeon	Pigeon
freelance	pigiste
Battery	piles
pillar	pilier
hairiness	pilosité
steering	pilotage
pilot	pilote
Pilot	Pilote
driven	pilotée
pilot	piloter
drivers	pilotes
pill	pilule
pimento	piment
peppers	piments
pine	pin
Pine	Pin
pliers	pince
Pineau	Pineau
Auk	Pingouin
penguins	pingouins
pioneer	pionnière
pioneers	pionniers
pipelines	pipelines
Piper	Piper
pipes	pipes
dive	piqué
pirate	pirate
hacked	piraté
worse	pire
worst	pires
Pisa	Pise
track	piste
tracks	pistes
Pistol	Pistol
Gun	Pistolet
guns	pistolets
pity	pitié
Pitte	Pitte
picturesque	pittoresque
peony	pivoine
pivot	pivot
pizza	pizza
PJ	PJ
pl	pl
placing	plaçant
place	place
placed	placées
investment	placement
place	placer
places	places
ceiling	plafond
beach	plage
beaches	plages
pleaded	plaidé
wound	plaie
complains	plaint
Complaints	plaintes
please	plaire
Pleasure	plaisance
Plaisance	Plaisance
jokes	plaisante
joke	plaisanterie
pleasure	plaisir
Pleasure	Plaisir
Please	plait
plan	plan
board	planche
plankton	plancton
glide	plané
planets	planètes
planning	planification
schedule	planning
Plans	plans
plant	plante
planted	planté
planted	plantée
plant	planter
planter	planteur
plate	plaque
Plate	Plaque
plates	plaques
plasma	plasma
plastic	plastique
Plastics	plastiques
flat	plat
Tray	Plateau
platform	plateforme
platform	plate-forme
Platform	Plateforme
Platinum	Platinum
Plato	Platon
dishes	plats
playoffs	playoffs
full	plein
fully	pleinement
full	pleins
fullness	plénitude
cry	pleurer
raining	pleuvait
folding	pliage
bend	plier
folds	plis
plumbing	plomberie
plumber	plombier
Plumbers	Plombiers
diving	plongée
dive	plonger
plugin	plugin
rain	pluie
feather	plume
feathers	plumes
mostly	plupart
multidisciplinary	pluridisciplinaire
more	plus
several	plusieurs
Several	Plusieurs
rather	plutôt
rainy	pluvieux
pluviometry	pluviométrie
pm	pm
SMEs	PME
pneumatic	pneumatique
tires	pneumatiques
tires	pneus
Po	Po
PO	PO
pocket	poche
pockets	poches
wallet	pochette
pockets	pochettes
pod	pod
podium	podium
podiums	podiums
Poem	Poem
poet	poète
poets	poètes
dagger	poignard
handles	poignées
wrist	poignet
hair	poil
pile	poils
point	point
Point	Point
tip	pointe
points	points
Pointed	pointues
pear	poire
pears	poires
peas	pois
Peas	Pois
poison	poison
fish	poisson
Fish	Poisson
fish	poissons
Poitiers	Poitiers
peppers	poivrons
Pokémon	Pokémon
polar	polaire
thriller	polar
polarization	polarisation
pole	pole
pole	pôle
Pole	Pôle
controversy	polémique
polished	poli
police	police
policeman	policier
police	policière
police	policiers
polished	polis
political	politique
policies	politiques
pollen	pollen
Pollution	Pollution
Polo	Polo
Poland	Pologne
Polish	polonais
Polish	Polonais
polonaise	polonaise
Polish	polonaises
Polski	Polski
polytechnic	polytechnique
multipurpose	polyvalent
Versatile	polyvalente
pom	pom
apple	pomme
pump	pompe
pumps	pompes
Pumps	Pompes
Pompidou	Pompidou
timely	ponctuelle
pond	pond
pony	poney
bridge	pont
Bridge	Pont
Pont-à-Mousson	Pont-à-Mousson
clutch	ponte
pontificate	pontificat
pontoon	ponton
Bridges	Ponts
Top	populaires
popularity	popularité
pork	porc
porches	porches
Swine	porcine
porous	poreuse
pornography	pornographie
port	port
Port	Port
portable	portable
Portable	portables
wore	portaient
portal	portail
Portal	Portail
wore	portait
bearing	portant
portable	portatif
Portable	portatives
door	porte
Door	Porte
focused	porté
scope	portée
portfolio	portefeuille
wear	porter
will	portera
worn	portés
carrier	porteur
carrier	porteuse
servings	portions
portico	portique
gantries	portiques
Port	Porto
portrait	portrait
portraits	portraits
Portuguese	portugais
Portuguese	Portugais
Portuguese	portugaise
Portugal	Portugal
pose	pose
laid	posé
pose	posent
pose	poser
poseur	poseur
position	position
position	positionner
positions	positions
has	possède
possession	possession
possibility	possibilité
possible	possible
possibly	possiblement
post	post
Post	Post
postal	postal
post	poste
posted	postée
poster	poster
posters	posters
posts	postes
posthumous	posthume
pot	pot
buddy	pote
pole	poteau
potential	potentiel
potential	potentielle
potentially	potentiellement
pottery	poterie
pottery	poteries
friends	potes
inch	pouces
powder	poudre
powders	poudres
Poul	Poul
foal	poulain
hen	poule
hens	poules
chicken	poulet
doll	poupée
to	pour
To	Pour
percentage	pourcentage
talks	pourparlers
Why	pourquoi
Why	Pourquoi
will	pourra
Will	Pourra
could	pourrais
could	pourrait
will	pourrez
rotten	pourri
could	pourrions
decay	pourriture
will	pourront
pursuit	poursuite
proceedings	poursuites
pursuer	poursuivant
continue	poursuivent
pursued	poursuivi
continue	poursuivre
yet	pourtant
Yet	Pourtant
periphery	pourtour
shoot	pousse
thrust	poussée
grow	poussent
shoots	pousses
dust	poussière
Dust	Poussière
Chick	Poussin
beams	poutres
could	pouvaient
could	pouvais
could	pouvait
can	pouvez
Can	Pouvez
could	pouvions
power	pouvoir
Power	Pouvoir
powers	pouvoirs
Power	Power
Prairie	Prairie
Practitioners	praticiens
practicing	pratiquant
Practicing	Pratiquant
practice	pratique
practiced	pratiqué
practically	pratiquement
practice	pratiquer
practices	pratiques
meadow	pré
prior	préalable
before	précédant
above	précède
Previous	précédentes
preaching	prêche
precious	précieuses
rainfall	précipitations
precipitates	précipite
precipitate	précipité
accurate	précis
stated	précisait
specifying	précisant
accurate	précise
clear	précisé
specify	préciser
advocates	préconise
precursor	précurseur
precursors	précurseurs
predator	prédateur
predecessor	prédécesseur
preaching	prédication
predict	prédire
predominance	prédominance
predominant	prédominante
predominate	prédominent
preferable	préférable
preference	préférence
prefer	préfèrent
prefer	préférer
prefect	préfet
Prefects	Préfets
foreshadows	préfigure
prefix	préfixe
prefixes	préfixes
prejudice	préjudice
Prejudice	préjugés
withdraw	prélever
first	premier
First	Premier
first	première
First	Première
first	premiers
First	Premiers
premises	prémisses
guard	prémunir
taking	prenait
Taking	Prenant
takes	prend
Takes	Prend
will	prendra
take	prendre
take	prendrons
take	prends
taker	preneur
take	prenez
take	prennent
Take	Prenons
worrying	préoccupant
concerns	préoccupations
concerned	préoccupé
preparing	préparait
preparations	préparatifs
Preparatio	Preparatio
preparation	préparation
Preparation	Préparation
preparations	préparations
preparatory	préparatoire
prepares	prépare
prepared	préparé
Prepared	Préparé
prepared	préparée
ready	préparent
prepare	préparer
meadows	prés
close	près
Close	Près
prescriptions	prescriptions
presence	présence
present	présent
with	présentant
presentation	présentation
Presentation	Présentation
this	présente
offered	présenté
Offered	Présenté
submitted	présentée
submitted	présentées
currently	présentement
exhibit	présentent
submit	presenter
present	présenter
present	présentera
These	présentes
Presents	Presents
present	présents
preserving	préservant
Condoms	préservatifs
preservation	préservation
preserved	préservée
chairs	préside
presidency	présidence
Presidency	Présidence
president	président
chairwoman	présidente
Presidential	présidentielle
Presidents	présidents
presumption	présomption
almost	presque
Almost	Presque
Press	Press
press	presse
Press	Presse
pressed	pressé
Presses	Presses
pressure	pression
pressures	pressions
benefit	prestation
Benefits	prestations
prestige	prestige
prestigious	prestigieuse
loan	prêt
ready	prête
claims	prétend
claimed	prétendait
pretender	prétendant
claimed	prétendit
claim	prétendre
alleged	prétendu
claims	prétentions
loan	prêter
ready	prêtes
excuse	prétexte
priest	prêtre
loans	prêts
evidence	preuve
evidence	preuves
prevailed	prévalait
prevalence	prévalence
prevail	prévalent
warn	prévenir
warned	prévenu
warned	prévenus
warns	prévient
forecast	prévision
forecast	prévoir
expected	prévoit
planned	prévoyaient
planned	prévu
provided	prévus
pray	prier
prayer	prière
priory	prieuré
Prima	Prima
primary	primaire
primary	primaires
primal	primal
Primal	primale
primacy	primauté
premium	prime
Premium	Prime
Premiums	primes
primitive	primitif
primitive	primitive
primarily	primitivement
primary	primordiale
prince	prince
Prince	Prince
princes	princes
Princess	Princess
princess	princesse
Princess	Princesse
main	principal
main	principale
mainly	principalement
principality	principauté
main	principaux
principle	principe
principles	principes
Principles	Principles
spring	printemps
Spring	Printemps
priori	priori
priorities	priorités
taken	pris
taking	prise
taken	prises
prison	prison
prisoner	prisonnier
took	prit
Private	privatif
deprivation	privation
privatization	privatisation
deprives	prive
Private	privée
Private	privées
deprive	priver
Private	privés
privileges	privilèges
privilege	privilégier
price	prix
Price	Prix
pro	pro
Pro	Pro
Proba	Proba
probability	probabilité
likely	probable
probably	probablement
Probably	Probablement
Probiotics	probiotiques
issues	problématiques
issue	problème
difficulties	problèmes
proceeds	procède
proceed	procéder
processes	procédés
proceedings	procédures
Trial	Procès
processor	processeur
record	procès-verbal
next	prochain
next	prochaine
close	proche
Close	Proche
close	proches
proclaim	proclament
proclaim	proclamer
obtain	procurer
prosecutor	procureur
prodigy	prodige
prodigal	prodigue
producers	producteurs
production	production
Production	Production
Productions	Productions
producer	productrice
produce	produire
produce	produisent
product	produit
Product	Produit
Products	produits
Products	Produits
prof	prof
professor	professeur
Professor	Professeur
profession	profession
professionalism	professionnalisme
professional	professionnel
Professional	Professionnel
Professional	professionnelles
Professional	professionnels
Professions	professions
profile	profil
profiles	profils
profit	profit
advantage	profitant
benefits	profite
advantage	profité
benefit	profiter
profiteer	profiteur
Enjoy	Profitez
earnings	profits
deeply	profondément
deep	profondes
depth	profondeur
profs	profs
offspring	progéniture
programming	programmation
program	programme
programs	programmes
progress	progrès
move	progresser
progressive	progressif
progressive	progressiste
progressive	progressive
Project	Project
projectile	projectile
projection	projection
projection	projections
project	projet
Project	Projet
projected	projeté
projects	projets
plans	projette
prologue	prologue
extends	prolonge
extension	prolongement
extend	prolonger
walk	promenade
walks	promène
promenade	promener
promises	promet
promising	prometteur
promising	prometteuse
promise	promettre
specials	promos
developer	promoteur
developers	promoteurs
promotion	promotion
Promotion	Promotion
promotions	promotions
promote	promouvoir
promoted	promu
Prefer	prononce
pronounced	prononcé
pronounced	prononcée
pronounce	prononcer
pronounced	prononcés
pronunciation	prononciation
prognosis	pronostic
prophet	prophète
prophecy	prophétie
suitable	propice
proportion	proportion
Proportional	proportionnelle
About	propos
applicant	proposant
offers	propose
proposed	proposé
proposed	proposée
proposed	proposées
propose	proposer
offered	proposés
proposal	proposition
available	proposons
own	propre
Own	Propre
cleanliness	propreté
owner	propriétaire
Owner	Propriétaire
owners	propriétaires
proprioception	proprioception
prose	prose
thriving	prospère
thrive	prospérer
successful	prospères
prosperity	prospérité
prostitute	prostituée
players	protagonistes
protector	protecteur
protection	protection
protectorate	protectorat
protects	protège
protected	protégé
protecting	protégeant
Protected	protégées
protect	protéger
protests	protestations
protest	protester
protocol	protocol
protocol	protocole
prototype	prototype
came	provenait
provenance	provenance
from	provenant
Provencal	provençale
from	proviennent
Comes	Provient
Province	Province
Provincial	provinciales
supplies	provisions
tentatively	provisoirement
challenger	provocateur
provocation	provocation
causes	provoque
caused	provoqué
provoke	provoquer
proximity	proximité
Proxy	proxy
caution	prudence
Caution	Prudence
cautious	prudent
Cautious	Prudent
cautious	prudente
prune	pruneau
Ps	Ps
PS	PS
PSA	PSA
pseudonym	pseudonyme
psychiatrist	psychiatre
psychiatry	psychiatrie
psychic	psychique
psychology	psychologie
psychological	psychologique
psychologist	psychologue
PT	PT
able	pu
stank	puait
stench	puanteur
Pub	Pub
public	public
publication	publication
Publications	Publications
advertising	publicitaires
advertising	publicité
Advertising	Publicité
Public	publics
published	publié
Published	Publié
publish	publient
publish	publier
published	publiés
Public	publiques
pubs	pubs
Maid	Pucelle
then	puis
Then	Puis
draws	puise
SINCE	puisqu'
since	puisque
power	puissance
powers	puissances
powerful	puissant
powerful	puissante
well	puits
punished	puni
punishes	punit
punishment	punition
punk	punk
pure	pur
clear	pure
pure	pures
purge	purge
purged	purgée
manure	purin
pus	pus
could	put
Whore	Putain
Q	Q
Qatar	Qatar
that	qu
that	qu'
That	Qu'
quad	quad
quadratic	quadratique
quadruple	quadruples
dock	quai
Dock	Quai
wharves	quais
qualifications	qualifications
calls	qualifie
qualified	qualifié
Qualified	qualifiées
quality	qualité
Quality	Qualité
when	quand
When	Quand
about	quant
As	Quant
Quantitative	quantitatives
quantity	quantité
quarantine	quarantaine
forty	quarante
quarter	quart
neighborhood	quartier
Neighborhood	Quartier
neighborhoods	quartiers
almost	quasi
Quasimodo	Quasimodo
fourteen	quatorze
four	quatre
Four	Quatre
ninety	quatre-vingt-dix
fourth	quatrième
quattro	quattro
quartet	quatuor
that	que
That	Que
Quebec	Quebec
Quebec	Québec
Quebec	québécoise
quechua	quechua
what	quel
What	Quel
any	quelconque
what	quelle
What	Quelle
What	quelles
What	Quelles
some	quelque
Some	Quelque
some	quelques-uns
someone	quelqu'un
What	quels
What	Quels
quarrel	querelle
quarrels	querelles
question	question
Issue	Question
issues	questions
tail	queue
that	qui
Who	Qui
Quick	Quick
whosoever	quiconque
left	quitta
quits	quitte
left	quitté
leave	quittent
leave	quitter
quiz	quiz
quo	quo
what	quoi
though	quoique
Though	Quoique
daily	quotidien
daily	quotidienne
daily	quotidiennement
daily	quotidiennes
daily	quotidiens
R	R
R.	R.
discount	rabais
Rabat	Rabat
Raccoon	Raccoon
connection	raccordement
connected	raccordés
race	race
races	races
buying	rachetant
Rachid	Rachid
racial	racial
root	racine
roots	racines
Racing	Racing
racism	racisme
racketeering	racket
recounted	raconté
recount	racontent
radar	radar
radar	radars
roadstead	rade
radical	radical
Radical	Radical
Radical	radicale
radicals	radicaux
raft	radier
radio	radio
Radio	Radio
Radioactive	radioactifs
Radioactive	radioactives
refining	raffinage
refined	raffinée
refinement	raffinement
refined	raffinés
rafting	rafting
gossip	ragots
raid	raid
stiff	raide
Straight	raides
raiding	raids
ray	raie
tracks	rails
grapes	raisin
reason	raison
Reason	Raison
reasonable	raisonnable
reasonable	raisonnables
reasoning	raisonnement
reasons	raisons
Rajendra	Rajendra
Rajesh	Rajesh
add	rajoute
slowed	ralentie
replays	ralentis
deceleration	ralentissement
rally	rallie
rally	rallier
rally	rallye
collect	ramassent
returns	ramène
rowing	rames
Ramos	Ramos
Ran	Ran
rand	rand
Rand	Rand
trek	randonnée
rank	rang
Range	Range
Raoul	Raoul
repatriate	rapatrié
repatriate	rapatrier
grated	râpé
fast	rapide
Fast	Rapide
quickly	rapidement
rapid	rapides
reminder	rappel
remembered	rappela
recalled	rappelé
remember	rappeler
recalls	rappelle
Remember	Rappelons
report	rapport
Report	Rapport
reports	rapporte
reported	rapporté
report	rapportent
report	rapporter
relations	rapports
close	rapproche
near	rapproché
close	rapprochées
reconciliation	rapprochement
close	rapprochés
rare	rare
rarely	rarement
rare	rares
scarcity	rareté
Ras	Ras
RAS	RAS
shave	raser
shaver	rasoir
rally	rassemblement
together	rassemblés
reassure	rassure
reassure	rassurer
Rat	Rat
spleen	rate
Spleen	Rate
missed	raté
miss	rater
failures	ratés
rating	rating
streamlines	rationalise
rational	rationnel
rational	rationnelle
RATP	RATP
catches	rattrape
ravage	ravagent
ravage	ravager
devastating	ravageur
Raven	Raven
delighted	ravi
delighted	ravie
delighted	ravis
kidnappers	ravisseurs
delights	ravit
refuel	ravitailler
Raw	Raw
Ray	Ray
radius	rayon
rays	rayons
scratches	rayures
raz	raz
RC	RC
appointment	rdv
Re	Ré
Ra	Rê
reactor	réacteur
Reactors	réacteurs
reaction	réaction
reactions	réactions
Reagan	Reagan
responded	réagi
director	réalisateur
directors	réalisateurs
realization	réalisation
executed	réalisé
performed	réalisée
performed	réalisées
achieve	réaliser
realism	réalisme
realistic	réaliste
reality	réalité
facts	réalités
reorganization	réaménagement
resuscitation	réanimation
rebel	rebelle
rebels	rebelles
bounce	rebondir
rebound	rebondissement
summary	récapitule
contains	recèle
recently	récemment
lists	recense
census	recensement
recent	récent
Recent	récentes
Recent	récents
reception	reception
recipe	recette
receiving	recevant
receiver	receveur
receive	recevons
receive	recevra
reloaded	rechargés
heated	réchauffé
Warming	réchauffement
search	recherche
Search	Recherche
sought	recherchée
search	rechercher
research	recherches
sought	recherchés
reef	récif
reefs	récifs
story	récit
recite	récitent
stories	récits
advertising	réclame
claimed	réclamé
receives	reçoit
pick	recoller
harvest	récolte
harvest	récolter
Recommendations	recommandations
Recommended	recommandée
recommended	recommandons
restart	recommencer
reward	récompense
Rewards	récompenses
reconciled	réconcilié
reconcile	réconcilier
comfort	réconfort
recognition	reconnaissance
recognitions	reconnaissances
recognize	reconnaissent
recognize	reconnaitre
recognized	reconnue
recognized	reconnues
reconquest	reconquête
reconstituted	reconstituée
rebuild	reconstruire
reconvert	reconvertir
record	record
resort	recourent
resort	recours
covered	recouverte
covered	recouverts
covers	recouvre
recovery	recouvrement
recover	recouvrer
covered	recouvrit
recruits	recrues
recruitment	recrutement
rectangle	rectangle
rectangular	rectangulaire
correct	rectifier
straight	rectiligne
received	recu
received	reçu
received	reçue
collection	recueil
collected	recueillies
collect	recueillir
recoil	recul
back	recule
back	reculer
recovery	récupération
recovers	récupère
recover	récupérer
recurring	récurrent
Received	reçus
received	reçut
Red	Red
writing	rédaction
surrender	reddition
redemption	rédemption
writes	rédige
written	rédigé
written	rédigée
write	rédiger
dreaded	redout
formidable	redoutable
redoubt	redoute
straighten	redresser
reduction	réduction
reduce	réduire
reducing	réduisant
reduced	réduit
reissue	rééditer
real	réel
re-election	réélection
real	réelle
actually	réellement
real	réelles
revaluation	réévaluation
reconsideration	réexamen
repair	réfection
Reference	Référence
References	références
References	Références
referendum	référendum
refer	référer
closes	referme
thoughtful	réfléchi
thoughtful	réfléchie
think	réfléchir
thought	réfléchit
reflects	reflète
reflect	reflètent
reflexes	réflexes
reflections	réflexions
reformation	réformation
reform	réforme
Reform	Réforme
refrigerator	réfrigérateur
shelter	refuge
refuge	réfugier
Refugees	réfugiés
refused	refusa
refusing	refusant
refuses	refuse
refuse	refuser
returning	regagnent
regain	regagner
feast	régaler
look	regard
watching	regardaient
watch	regarde
watch	regarder
eyes	regards
reggae	reggae
governed	régi
Régie	Régie
regime	régime
Regiment	Régiment
Régine	Régine
area	région
Area	Région
Regional	régionale
regional	régionales
areas	régions
Régis	Régis
steward	régisseur
register	registre
records	registres
governs	régit
rule	règle
regulation	règlement
regulations	réglementations
regulates	réglemente
regulations	règlements
settle	régler
rules	règles
reign	régné
abounds	regorge
regret	regret
regretting	regrettant
regrets	regrette
regret	regretter
gathering	regroupant
grouping	regroupement
gather	regrouper
regularity	régularité
regular	régulier
regular	régulière
regularly	regulierement
regularly	régulièrement
regular	réguliers
Queen	Reine
waist	reins
rejection	rejet
rejected	rejeté
reject	rejettent
join	rejoignent
meet	rejoindre
join	rejoindront
joined	rejointe
respite	relâche
relay	relais
revival	relance
revive	relancer
recounts	relate
Related	relatifs
relation	relation
relationship	relations
relatively	relativement
on	relatives
relax	relax
relaxed	relaxé
within	relevant
statement	relevé
raise	relever
linking	reliant
connects	relie
connected	reliée
relief	relief
reliefs	reliefs
link	relient
link	relier
religious	religieuse
Religious	Religieuse
Religious	religieuses
religion	religion
Religion	Religion
religions	religions
Religions	Religions
Proofread	Relisez
noticed	remarqua
remarkable	remarquable
Note	remarque
Note	remarqué
notice	remarquer
refunded	remboursé
repay	rembourser
remedies	remèdes
remedy	remédier
Remedy	Remedy
thanks	remercie
thanks	remerciements
thank	remercier
returns	remet
furnish	remette
recover	remettent
reset	remettre
reminiscences	réminiscences
handed	remis
Remis	Remis
discounts	remises
back	remonte
lifts	remontées
back	remontent
recover	remonter
remorse	remords
trailer	remorque
towed	remorqué
rampart	rempart
Battlements	Remparts
replaces	remplace
replaced	remplacé
replaced	remplacée
replace	remplacer
replaced	remplacés
filled	rempli
fill	remplir
filled	remplis
fills	remplit
win	remportent
win	remportera
remuneration	rémunération
Ren	Ren
reborn	renaître
Fox	Renard
met	rencontra
meeting	rencontre
met	rencontré
met	rencontrée
meet	rencontrer
meet	rencontrera
meetings	rencontres
met	rencontrés
makes	rend
made	rendait
makes	rende
yield	rendement
make	rendent
appointment	rendez
appointment	rendez-vous
went	rendit
make	rendre
made	rendu
made	rendue
reins	rênes
contain	renferment
strengthens	renforce
reinforced	renforcée
strengthening	renforcement
strengthen	renforcer
reinforcement	renfort
disown	renie
Rennes	Rennes
Reno	Reno
renown	renom
renowned	renommé
reappoint	renommer
renounced	renoncé
renounce	renoncer
revives	renoue
renewal	renouveau
renewed	renouvelée
renews	renouvelle
renovated	rénové
renovate	rénover
information	renseigne
informed	renseigné
information	renseignement
inquire	renseigner
profitability	rentabilité
profitable	rentable
profitable	rentables
annuity	rente
returning	rentrant
returns	rentre
return	rentrer
overthrew	renversa
turning	renverse
reversed	renversé
reversal	renversement
overthrow	renverser
return	renvoi
reorganization	réorganisation
den	repaire
spreads	répand
widespread	répandu
widespread	répandue
widespread	répandues
repair	réparation
repairs	réparations
repairs	répare
fixed	réparé
repair	réparer
spread	réparti
spread	réparties
restart	repartir
spread	répartis
reappeared	reparu
meal	repas
ironing	repassage
rethought	repensée
repentance	repentir
spotting	repérage
impact	répercussions
spotted	repéré
benchmarks	repères
repertoire	répertoire
Repertoire	Répertoire
listed	répertorié
repeat	répète
repeated	répété
Repeated	répétée
repeat	répéter
repeat	répétition
rehearsals	répétitions
replica	réplique
Replicas	répliques
answers	répond
answer	répondez
reply	réponse
answers	réponses
postponement	report
reportage	reportage
reporter	reporter
Rest	Repos
based	reposaient
rests	repose
based	reposent
rest	reposer
repellent	repoussant
regrowth	repousse
postponed	repoussée
resume	reprendra
resume	reprendre
buyer	repreneur
buyers	repreneurs
retaliation	représailles
represented	représentaient
representative	représentant
representative	représentatif
representation	représentation
representations	représentations
representative	représentative
representativeness	représentativité
represents	représente
represented	représenté
represented	représentée
represented	représentés
represses	réprime
repressed	réprimé
resumed	reprirent
included	repris
recovery	reprise
times	reprises
resumed	reprit
criticized	reproché
reproach	reprocher
reproduction	reproduction
reptiles	reptiles
Republican	républicaine
renowned	réputé
reputable	réputés
petitioner	requérant
shark	requin
required	requis
Requisitions	réquisitions
survivors	rescapés
network	réseau
Network	Réseau
networks	réseaux
reservations	réservations
reserve	réserve
reserved	réservé
book	réservez
tanks	réservoirs
resident	résidant
lies	réside
residence	résidence
residential	résidentiel
residues	résidus
strength	résistance
resistant	résistante
resist	résister
solve	résolvent
resonance	résonance
solve	résoudre
respect	respect
respectable	respectable
respecting	respectant
respects	respecte
comply	respectent
respect	respecter
respective	respectif
respectively	respectivement
respective	respectives
breathing	respiration
respiratory	respiratoire
respiratory	respiratoires
breathes	respire
responsible	responsables
likeness	ressemblance
similar	ressemblent
feels	ressent
felt	ressenti
felt	ressentie
feel	ressentir
emerged	ressorti
citizens	ressortissants
resources	ressources
Resources	Ressources
resurrect	ressusciter
Remaining	restants
restaurant	restau
restaurant	restaurant
Restaurant	Restaurant
restaurants	restaurants
restoration	restauration
Restoration	Restauration
restore	restaurer
rest	reste
stayed	resté
stay	restent
stay	rester
stay	restera
stay	resteront
remains	restes
stayed	restés
stay	restons
restriction	restriction
result	résultat
Result	Résultat
results	résultats
results	résulte
summary	résume
summary	résumé
summarize	résumer
restore	rétablir
recovery	rétablissement
delay	retard
delays	retarde
delayed	retardé
delay	retarder
delays	retards
resounding	retentissement
withheld	retenu
selected	retenus
retains	retient
retina	rétine
withdraws	retire
withdrawn	retiré
withdraw	retirer
removed	retirés
fallout	retombée
benefits	retombées
return	retour
returns	retourne
returned	retourné
return	retourner
return	retournera
returned	retournèrent
Returns	retours
traces	retrace
withdrawal	retrait
retirement	retraite
retired	retraité
pensions	retraites
retro	rétro
found	retrouva
reunion	retrouvailles
Regaining	Retrouvant
found	retrouve
found	retrouvé
found	retrouvée
found	retrouvées
found	retrouvent
find	retrouver
find	retrouvera
Find	Retrouvez
Returns	Returns
met	réunie
meeting	réunion
Reunion	réunionnais
Reunion	réunionnaise
meetings	réunions
gather	réunir
meet	réunira
gather	réuniront
together	réunis
together	réunit
successful	réussi
succeed	réussir
Succeed	Réussir
Successful	réussissent
successful	réussit
Reuters	Reuters
Rev	Rev
revenge	revanche
dream	rêve
wake	réveille
wake	réveiller
wake	réveillez
Revel	Revel
revealing	révélateur
reveal	révéler
ghosts	revenants
resells	revend
claims	revendique
claim	revendiquer
sell	revendre
Revenge	Revenge
return	revenir
income	revenu
returned	revenue
earnings	revenus
dream	rêver
return	reviendrons
return	reviennent
return	reviens
returns	revient
returned	revinrent
Revised	révisé
Revised	révisée
review	réviser
revision	révision
relive	revivre
reviewing	revoit
revolt	révolte
Revolution	Révolution
revolutionary	révolutionnaire
revolutionises	révolutionne
revolutionize	révolutionner
revolver	revolver
reviewed	revu
review	revue
reviews	revues
Rex	Rex
Rhine	Rhin
rhino	rhinocéros
Rhonda	Rhonda
rum	rhum
laughing	riant
rich	riche
rich	riches
wealth	richesse
wealth	richesses
Rico	Rico
ridiculous	ridicule
ridicules	ridiculise
Ridley	Ridley
nothing	rien
Nothing	Rien
Rights	Rights
Rigid	rigides
rigorous	rigoureuse
rigor	rigueur
Riki	Riki
rinse	rincer
ring	ring
laugh	rire
risk	risque
ritual	rituels
seashores	rivages
rivals	rivalise
shore	rive
Riparian	riveraines
residents	riverains
Rivet	Rivet
river	rivière
rice	riz
RKO	RKO
Road	Road
Roar	Roar
dress	robe
Robin	Robin
tap	robinet
taps	robinets
fittings	robinetterie
robot	robot
rock	roche
rock	rocher
rocks	roches
rocky	rocheuses
rock	rock
Rock	Rock
Rod	Rod
Roda	Roda
Rodrigues	Rodrigues
Roger	Roger
Rogers	Rogers
king	roi
King	Roi
kings	rois
Kings	Rois
roles	rôles
roll	roll
Rollet	Rollet
rom	rom
ROM	ROM
Roman	romain
Roman	romaine
novel	roman
romance	romance
fiction	romanesque
novels	romans
romantic	romantique
romanticism	romantisme
breaks	rompt
washers	rondelles
round	rondes
Room	Room
Roosevelt	Roosevelt
Rosario	Rosario
pink	rose
Pink	Rose
ROSE	ROSE
reeds	roseaux
roses	roses
Roses	Roses
Rosie	Rosie
nightingale	rossignol
rotary	rotatif
rotation	rotation
rotations	rotations
Rotterdam	Rotterdam
wheel	roue
red	rouge
Red	Rouge
red	rouges
Red	Rouges
rust	rouille
Rollers	Rouleaux
rolling	roulement
Romania	Roumanie
round	round
Round	Round
rupees	roupies
redhead	rousse
Rousseau	Rousseau
road	route
roads	routes
truck	routier
road	routière
red	roux
Red	Roux
roy	roy
royal	royal
Royan	Royan
kingdom	royaume
Kingdom	Royaume
Kingdoms	royaumes
Royal	royaux
RSC	RSC
Rub	Rub
ribbon	ruban
ruby	rubis
rubric	rubrique
Ruby	Ruby
Ruch	Ruch
rough	rude
rudimentary	rudimentaire
street	rue
Street	Rue
alley	ruelle
streets	rues
ruin	ruine
ruined	ruiné
creek	ruisseau
rumor	rumeur
rumors	rumeurs
Run	Run
running	running
break	rupture
Rural	rurale
Rural	ruraux
ruse	ruse
Rush	Rush
Russian	russe
Russia	Russie
rustic	rustique
Rwanda	Rwanda
Ryan	Ryan
pace	rythme
rhythms	rythmes
s	s
s'	s'
S	S
S9	S9
his	sa
His	Sa
SA	SA
Saadi	Saadi
Sabah	Sabah
sand	sable
sabotage	sabotage
sabotage	sabotages
clogs	sabots
saber	sabre
bag	sac
Sacha	Sacha
know	sache
sacre	sacre
sacred	sacré
sacred	sacrée
sacrifices	sacrifices
sacrifice	sacrifier
bags	sacs
safety	safety
saga	saga
wise	sage
wise	sages
Sages	Sages
wisdom	sagesse
Sagittarius	Sagittaire
Saguenay-Lac-Saint-Jean	Saguenay-Lac-Saint-Jean
Sahara	Sahara
SAI	SAI
Said	Said
bleeding	saignée
bleeding	saignement
sail	sail
healthy	sain
healthy	sainement
saint	saint
St.	Saint
Saint-Barthélemy	Saint-Barthélemy
Holy	sainte
Sainte-Barbe	Sainte-Barbe
holiness	sainteté
Saint-Jacques	saint-jacques
Saint-Maclou	Saint-Maclou
Saint-Martin	Saint-Martin
Saint-Ouen	Saint-Ouen
saints	saints
Saint-Sauveur	Saint-Sauveur
know	sais
grasped	saisi
seizure	saisie
foreclosures	saisies
grasp	saisir
before	saisis
grabs	saisit
Season	Saison
seasons	saisons
knows	sait
Sal	Sal
Sala	Sala
Salafists	salafistes
Salah	Salah
salary	salaire
wages	salaires
Salamis	Salamine
wage	salariale
salaried	salarié
workforce	salariés
dirty	sale
salt	salée
Salted	salées
Salem	Salem
dirt	saleté
Saliou	Saliou
room	salle
Room	Salle
rooms	salles
Sally	Sally
Solomon	Salomon
salon	salon
crap	saloperies
healthy	salubre
greet	salue
greet	saluer
salvation	salut
Hi	Salut
Salvador	Salvador
SAM	SAM
Sami	same
Saturday	samedi
Saturday	Samedi
Saturdays	samedis
Samir	Samir
Samoa	Samoa
Samothrace	Samothrace
sample	sample
Samsung	Samsung
San	San
Sancho	Sancho
sanction	sanction
sanctioned	sanctionné
sanction	sanctionner
sanctions	sanctions
sandwiches	sandwichs
blood	sang
bloody	sanglant
bloody	sanglante
bloody	sanglantes
webbing	sangles
Boar	Sanglier
sanguine	sanguin
bloodthirsty	sanguinaire
bloodthirsty	sanguinaires
sanguine	sanguine
sanitary	sanitaire
without	sans
Without	Sans
homeless	sans-abris
Sant	Sant
Santa	Santa
health	santé
Health	Santé
São	São
Saône	Saône
notices	s'aperçoit
sapphire	saphir
Sarah	Sarah
Sarthe	Sarthe
Sartre	Sartre
SAS	SAS
Satan	Satan
satellite	satellite
satire	satire
satirical	satirique
satisfaction	satisfaction
satisfy	satisfaire
satisfied	satisfait
satisfied	satisfaite
saturated	saturé
Saturn	Saturne
sauce	sauce
sausages	saucisses
except	sauf
Except	Sauf
willow	saules
jump	saut
jumping	sautant
jumps	saute
sprung	sauté
jumps	sauts
wild	sauvage
wild	sauvages
saves	sauve
saved	sauvé
saved	sauvée
safeguard	sauvegarde
save	sauver
rescue	sauvetage
save	sauvons
Sava	Sava
knew	savais
savannah	savane
scientist	savant
scholars	savants
Savard	Savard
know	savent
flavor	saveur
flavors	saveurs
Savoy	Savoie
know	savoir
relish	savourer
tasty	savoureuse
tasty	savoureux
sax	saxo
saxophone	saxophone
Say	Say
skits	saynètes
SC	SC
scandal	scandale
Scandinavia	Scandinavie
scanner	scanner
Seals	sceaux
scriptwriter	scénariste
writers	scénaristes
scene	scène
scenes	scènes
scenic	scénique
Skeptics	sceptiques
diagram	schéma
schism	schisme
Schneider	Schneider
Schola	Schola
school	school
School	School
scientific	scientifique
sparkles	scintille
school	scolaire
schooling	scolarité
scooter	scooter
score	score
Score	Score
Scorpio	Scorpion
scotch	scotch
scribe	scribe
Script	Script
Scripts	scripts
carved	sculpté
carved	sculptées
carved	sculptés
sculpture	sculpture
sculptures	sculptures
himself	se
Himself	Se
Sea	Sea
SEAL	SEAL
session	séance
sessions	séances
Search	Search
Seb	Seb
Sebastian	Sebastian
Sébastien	Sébastien
dry	sec
SEC	SEC
dry	sèche
dried	séché
dry	sécher
drought	sécheresse
second	second
Second	Second
secondary	secondaire
secondary	secondaires
second	seconde
Second	Seconde
second	seconds
rescue	secourir
relief	secours
rescued	secouru
shock	secousse
Secret	Secret
secret	secrète
secreted	sécrétées
secrets	secrets
sectarian	sectaire
Sects	sectes
sector	secteur
sections	sections
security	sécurisation
Secure	sécurisé
reassure	sécuriser
safe	sécuritaire
safe	sécuritaires
security	sécurité
Security	Sécurité
sediment	sédiment
seductive	séducteur
seduced	séduit
see	see
See	See
segment	segment
segregation	ségrégation
lord	seigneur
Lord	Seigneur
stately	seigneuriale
lordship	seigneurie
Seine	Seine
bosom	seins
earthquake	séisme
stay	séjour
stays	séjourne
stays	séjours
salt	sel
selection	sélection
Selection	Sélection
selected	sélectionné
selected	sélectionnées
Selected	sélectionnés
stools	selles
Sem	Sem
week	semaine
Week	Semaine
weeks	semaines
similar	semblable
similar	semblables
appeared	semblaient
seemed	semblait
seems	semble
appeared	semblé
appear	semblent
seed	semence
Seeds	semences
sow	semer
seminar	séminaire
seminars	séminaires
semiologic	sémiologique
Sen	Sen
S'en	S'en
senate	sénat
Senate	Sénat
Senegal	Senegal
Senegal	Sénégal
Senegalese	sénégalaise
senior	senior
Senior	Senior
meaning	sens
sensitive	sensible
felt	sentait
Feeling	sentant
sentence	sentence
feel	sentent
felt	senti
trail	sentier
Trail	Sentier
trails	sentiers
feeling	sentiment
Feeling	Sentiment
feelings	sentiments
feel	sentir
felt	sentit
SEO	SEO
Seoul	Séoul
separation	séparation
Separate	séparée
separately	séparément
seven	sept
Seven	Sept
September	septembre
north	septentrion
burial	sépulture
burials	sépultures
sequence	séquence
sequences	séquences
will	sera
Will	Sera
would	seraient
would	serait
serene	sereine
will	serez
Serge	Serge
sergeant	sergent
Sergiu	Sergiu
Serie	Serie
series	série
Series	Série
Series	Series
series	séries
serious	sérieuse
seriously	sérieusement
serious	sérieuses
serious	sérieux
oath	serment
will	seront
snake	serpent
winds	serpente
snakes	serpents
floorcloth	serpillère
Greenhouse	Serre
tight	serré
Locksmith	Serrurerie
serves	sert
server	server
server	serveur
servers	serveurs
waitress	serveuse
served	servi
service	service
services	services
Services	Services
served	servie
served	servies
towel	serviette
will	servira
will	serviront
served	servis
servant	serviteur
servants	serviteurs
his	ses
His	Ses
session	session
Session	Session
single	seul
single	seule
only	seulement
Only	Seulement
only	seules
only	seuls
severe	sévère
Severe	Sévère
severely	sévèrement
Severe	sévères
rampant	sévit
weaning	sevrage
Sex	Sex
SEX	SEX
sex	sexe
Sexism	sexisme
sexual	sexuel
sex	sexuelles
sex	sexuels
sexy	sexy
Seychelles	Seychelles
GSP	SGP
shaker	shaker
Shane	Shane
Shanghai	Shanghai
Shanghai	Shanghaï
Shangri-La	Shangri-La
Shell	Shell
shen	shen
Sherlock	Sherlock
Sherman	Sherman
sherpa	sherpa
Shi	Shi
Shiraz	Shiraz
shoes	shoes
shop	shop
shopping	shopping
Shorter	Shorter
Shou	Shou
show	show
Show	Show
Showcase	Showcase
if	si
If	Si
Sic	Sic
Sicily	Sicile
AIDS	sida
seat	siège
Siemens	Siemens
Siena	Sienne
Sieur	sieur
Sig	Sig
SIG	SIG
signed	signa
signal	signal
reports	signale
reported	signalé
report	signaler
Safety	signalétique
signature	signature
sign	signe
signed	signé
meant	signifiait
meaning	signifiant
significant	significatifs
signification	signification
significant	significative
significantly	significativement
means	signifie
meant	signifié
signo	signo
silence	silence
silhouette	silhouette
silicon	silicium
silicone	silicone
similar	similaire
Similar	similaires
Simon	Simon
Simone	Simone
simple	simple
Simple	Simple
simply	simplement
simplifies	simplifie
simplified	simplifiée
simplified	simplifiées
simulations	simulations
simulate	simuler
Simultaneous	simultanée
together	simultanément
sincere	sincère
sincerely	sincèrement
Sincerely	Sincèrement
Sine	Sine
Singapore	Singapore
Singapore	Singapour
monkey	singe
Ape	Singer
single	single
sinologist	sinologue
otherwise	sinon
Otherwise	Sinon
sinusitis	sinusite
Zion	Sion
sir	sir
Sir	Sir
Sirens	sirènes
site	site
Site	Site
Sites	Sites
soon	sitôt
situation	situation
Situation	Situation
circumstances	situations
situated	situé
Situated	Situé
are	situent
locate	situer
six	six
sixth	sixième
Sixth	Sixième
sixth	sixte
ska	ska
skier	skieur
Skyway	Skyway
Slavic	slaves
Sledge	Sledge
Slim	Slim
panties	slip
slogan	slogan
Slogans	slogans
slots	slots
Slovak	Slovak
Slovakia	Slovaquie
Slovenia	Slovénie
Sm	Sm
Smallville	Smallville
smart	smart
smartphones	smartphones
SNC	SNC
SNCF	SNCF
So	So
nickname	sobriquet
Social	Social
social	sociales
Socialists	socialistes
social	sociaux
Society	Société
companies	sociétés
sociology	sociologie
sociologist	sociologue
plinth	socle
sodas	sodas
sodomy	sodomie
sister	soeur
sisters	soeurs
Sisters	Sœurs
Soft	Soft
Software	Software
self	soi
silk	soie
are	soient
thirst	soif
Caregivers	soignants
neat	soigné
careful	soignée
carefully	soigneusement
oneself	soi-même
care	soin
evening	soir
evening	soirée
nights	soirées
am	sois
whether	soit
sixty	soixante
ground	sol
Ground	Sol
Solar	solaires
solda	solda
balance	solde
sun	soleil
Sun	Soleil
solemn	solennel
Solf	Solf
solidary	solidaire
solidarity	solidarité
solid	solide
firmly	solidement
Solid	solides
soloist	soliste
solitary	solitaire
solicitation	sollicitation
solicits	sollicite
sought	sollicité
floors	sols
Solti	Solti
solutions	solutions
solvent	solvable
Somalia	Somalie
dark	sombre
dark	sombres
Some	Some
summary	sommaire
summary	sommaires
sum	somme
Sum	Somme
sleep	sommeil
top	sommet
Top	Sommet
tops	sommets
sumptuous	somptueuses
his	son
His	Son
SON	SON
poll	sondage
polls	sondages
probe	sonde
dream	songe
Sonia	Sonia
sounded	sonnait
sounds	sonne
rang	sonné
bell	sonnette
are	sont
Are	Sont
Sophie	Sophie
soprano	soprano
sorbet	sorbet
Sorbonne	Sorbonne
witchcraft	sorcellerie
sorcerer	sorcier
Witch	Sorcière
fiddlestick	sornette
fate	sort
outgoing	sortant
out	sortent
kinds	sortes
out	sorti
output	sortie
outputs	sorties
exit	sortir
release	sortira
out	sortis
sou	sou
bedrock	soubassement
convulsions	soubresauts
strains	souches
worry	souci
care	soucient
Anxious	Soucieux
troubles	soucis
suddenly	soudain
Sudan	Soudan
breath	souffle
blow	souffler
suffering	souffrance
suffering	souffrances
suffer	souffrir
wish	souhait
wishing	souhaitant
wishes	souhaite
Desired	souhaité
wish	souhaitent
want	souhaitez
soul	soul
Soul	Soul
raises	soulève
uprising	soulèvement
raise	soulever
highlighted	soulignait
highlighting	soulignant
highlights	souligne
highlighted	souligné
stress	souligner
highlighted	soulignés
Souls	Souls
submit	soumet
submitted	soumettait
submit	soumettre
submitted	soumise
submission	soumission
Sound	Sound
valves	soupapes
soup	soupe
supper	souper
sigh	soupir
flexible	souple
flexibility	souplesse
sources	sources
deaf	sourde
smile	sourire
mouse	souris
sly	sournois
under	sous
subscribe	souscrire
subscribed	souscrite
implies	sous-entend
underestimate	sous-estimer
subgroup	sous-groupe
Underlying	sous-jacentes
submarine	sous-marin
Diving	sous-marine
submarines	sous-marins
subtract	soustraire
subcontracting	sous-traitance
Hold	Soute
supported	soutenait
supporting	soutenant
support	soutenir
Support	Soutenir
support	soutenons
supported	soutenue
underground	souterrain
Ground	souterraine
Underground	souterrains
support	soutien
support	soutiendra
supports	soutient
memory	souvenir
remembrances	souvenirs
often	souvent
Sovereign	souverains
remember	souvient
Soviet	soviétiques
Be	Soyez
Sp	Sp
space	space
Spacious	spacieuse
spacious	spacieuses
Spain	Spain
Spanish	Spanish
Sparta	Sparte
Special	Special
special	spécial
Special	spéciale
specially	spécialement
specialized	spécialisé
specialize	spécialiser
expert	spécialiste
specialties	spécialités
Special	spéciaux
specificities	spécificités
specifically	spécifiquement
specific	spécifiques
show	spectacle
spectacular	spectaculaire
spectators	spectateurs
spectrum	spectre
speculation	spéculation
speculation	spéculations
Speed	Speed
spheres	sphères
Spider	Spider
spiral	spirale
splendor	splendeur
splendid	splendide
spoliation	spoliation
spontaneous	spontané
spontaneity	spontanéité
spontaneously	spontanément
sport	sport
Sport	Sport
sports	sportif
Sports	sportifs
sportswoman	sportive
Sportswoman	Sportive
Sports	sports
Sports	Sports
spot	spot
Spring	Spring
square	square
squash	squash
skeleton	squelette
St	St
stability	stabilité
stage	stade
Stadium	Stadium
training	stage
trainee	stagiaire
Stan	Stan
standard	standard
Standard	Standard
standards	standards
star	star
Stars	Stars
State	State
stationary	stationnaire
parked	stationné
static	statique
statistics	statistique
statistics	statistiques
Statistics	Statistiques
statue	statue
rule	statuer
statutes	statuts
Ste	Ste
Steel	Steel
stella	stella
Stéphanie	Stéphanie
steppes	steppes
Stereotypes	stéréotypes
sterile	stérile
Steve	Steve
Steven	Steven
stimulate	stimuler
stock	stock
storage	stockage
store	stocker
stocks	stocks
stop	stop
stop	stopper
story	story
Story	Story
Straight	Straight
Strange	Strange
Strasbourg	Strasbourg
ploy	stratagème
strategic	stratégique
Strategic	stratégiques
laminate	stratifié
Stressed	stressés
strict	strict
strictly	strictement
studious	studieux
studio	studio
studios	studios
amazement	stupéfaction
amazing	stupéfiant
stupid	stupide
stylish	stylé
styles	styles
stylized	stylisé
su	su
Su	Su
subconscious	subconscient
sustained	subi
undergo	subir
suffered	subis
experience	subissent
sudden	subit
suddenly	subitement
sublimation	sublimation
sublime	sublime
subject	subordonnée
surreptitiously	subrepticement
subsistence	subsistance
subsists	subsiste
substantive	substantive
substitute	substituer
grant	subvention
Subsidies	subventions
subversive	subversifs
juice	suc
succeeds	succède
succeed	succéder
success	succès
successor	successeur
successors	successeurs
Succession	Succession
successively	successivement
Successive	successives
sugar	sucre
sweet	sucré
sweet	sucrée
sweet	sucrées
Candy	Sucrerie
south	sud
South	Sud
Suede	Suède
Swedish	suedois
Swedish	Suédois
Swedish	suédoise
Sweat	Sueur
suffice	suffirait
enough	suffisamment
enough	suffisant
vote	suffrage
votes	suffrages
Suggested	suggéré
suggestion	suggestion
suicide	suicide
am	suis
Am	Suis
Swiss	suisse
Switzerland	Suisse
Swiss	suisses
Follows	Suit
following	suite
suites	suites
followed	suivait
next	suivant
Next	Suivant
Next	suivante
following	suivants
Followers	suiveurs
followed	suivie
followed	suivit
follow	suivre
Follow	Suivre
topic	sujet
Topic	Sujet
topics	sujets
Sully	Sully
Sultana	Sultana
great	super
Great	Super
superb	superbe
minimarket	supérette
area	superficie
Superficial	superficielles
top	supérieur
top	supérieure
Graduate	supérieures
top	supérieurs
supermarket	supermarché
superposition	superposition
great	supers
Additional	supplémentaires
beseech	supplie
support	support
supports	supporte
bear	supporter
suppose	suppose
assumed	supposé
supposedly	supposément
assume	supposer
suppression	suppression
removing	supprimant
removed	supprimé
removed	supprimées
remove	supprimer
supremacy	suprématie
supreme	suprême
on	sur
On	Sur
safe	sûr
upgrade	surclassement
Surcouf	Surcouf
moreover	surcroît
safe	sûre
heightens	surélève
surely	sûrement
safe	sûres
safety	sûreté
Safety	Sûreté
surf	surf
surface	surface
Area	Surface
surfaces	surfaces
Frozen	surgelé
Frozen	surgelée
Frozen	surgelés
arise	surgir
Suriname	Suriname
nickname	surnomme
nickname	surnommé
overhang	surplomb
overlooking	surplombant
overcrowding	surpopulation
surprising	surprenant
surprises	surprend
surprise	surprendre
surprised	surpris
surprises	surprises
mostly	surtout
surveillance	surveillance
occurred	survenu
occurred	survenue
occurred	survenus
occurs	survient
survive	survivra
flew	survolaient
likely	susceptibles
arouses	suscite
suspect	suspecter
suspects	suspects
suspended	suspendu
suspended	suspendue
suspended	suspendus
suspense	suspens
Suzette	Suzette
Sweet	Sweet
Swiss	Swiss
Sy	Sy
Sydney	Sydney
syllable	syllabe
syllables	syllabes
Silvan	Sylvain
symbol	symbole
symbolically	symboliquement
symbolizes	symbolise
symmetric	symétrique
nice	sympa
cool	sympas
nice	sympathique
friendly	sympathiques
supporters	sympathisants
sympathetic	sympatique
symphony	symphonie
symptomatic	symptomatique
symptom	symptôme
symptoms	symptômes
synagogue	synagogue
synchronized	synchronisé
trustee	syndic
syndicalist	syndicaliste
unionists	syndicalistes
union	syndicat
Union	Syndicat
unions	syndicats
synergy	synergie
synthetic	synthétique
Syria	Syrie
system	system
System	System
systematic	systématique
system	système
systems	systèmes
t	t
T	T
your	ta
TA	TA
tabacco	tabacco
tabarnac	tabarnac
clobber	tabasser
table	table
table	tableau
paintings	tableaux
tables	tables
shelves	tablettes
spot	tache
task	tâche
spotted	taché
tasks	tâches
stained	tachés
tacit	tacite
Tajikistan	Tadjikistan
Tag	Tag
tai	tai
size	taille
talent	talent
talented	talentueux
Talia	Talia
talk	talk
bank	talus
Tam	Tam
Tamango	Tamango
Tamara	Tamara
drum	tambour
drums	tambours
buffer	tampon
while	tandis
While	Tandis
tanneries	tanneries
so	tant
aunt	tante
sometimes	tantôt
Tanzania	Tanzanie
carpet	tapis
Tarbes	Tarbes
late	tard
delay	tarder
late	tardif
Taranto	Tarente
tariff	tarif
Tariff	Tarif
prices	tarifs
spread	tartiner
tattoo	tatouage
tattoos	tatouages
tattoo	tatouer
taupe	taupe
bull	taureau
bulls	taureaux
rate	taux
taxation	taxation
tax	taxe
tax	taxer
taxes	taxes
taxis	taxis
Chad	Tchad
you	te
Team	Team
TEC	TEC
Tech	Tech
technician	technicien
technique	technique
technology	technologie
Technology	technologies
technological	technologique
Technology	Technology
Teddy	Teddy
tint	teinte
tinted	teinté
colors	teintes
dyeing	teinture
such	tel
Such	Tel
TV	télé
TV	Télé
downloading	téléchargement
Telecommunications	télécommunications
telenovela	telenovela
phone	téléphone
Phone	Téléphone
phone	téléphoner
telephone	téléphonique
viewer	téléspectateur
audience	téléspectateurs
broadcast	télévisé
TV	télévision
TV	Télévision
televisions	télévisions
Tell	Tell
such	telle
This	Telle
so	tellement
such	telles
such	tels
witness	témoignage
testimonials	témoignages
Testimonials	Témoignages
witnessed	témoigné
witness	témoigner
witness	témoin
witnesses	témoins
temperament	tempérament
Temperature	Température
storm	tempête
storms	tempêtes
temple	temple
Temple	Temple
Templars	templiers
temporary	temporaire
time	temps
Time	Temps
thee	t'en
tenacious	tenace
held	tenaient
holding	tenant
tends	tend
trend	tendance
trends	tendances
tending	tendant
tend	tendent
tendons	tendons
tight	tendu
tense	tendues
tight	tendus
darkness	ténèbres
Darkness	Ténèbres
hold	tenir
tennis	tennis
tenor	ténor
Voltage	tension
tensions	tensions
tried	tenta
tempting	tentant
attempt	tentative
tent	tente
tried	tenté
trying	tentent
try	tenter
tents	tentes
Given	tenu
holding	tenue
ter	ter
procrastination	tergiversations
term	terme
terms	termes
finished	termina
termination	terminaison
terminal	terminal
terminal	terminale
ending	terminant
terminals	terminaux
finished	terminé
finished	terminée
end	terminent
ground	terrain
grounds	terrains
terrace	terrasse
earth	terre
Earth	Terre
earthly	terrestre
earthy	terreux
Earthlings	terriens
territory	territoire
territories	territoires
Territorial	territoriales
terroir	terroir
terrorism	terrorisme
terrorist	terroriste
Terry	Terry
your	tes
Test	Test
will	testament
Will	Testament
tests	teste
testicles	testicules
tests	tests
head	tête
text	texte
texts	textes
Textiles	textiles
TG	TG
TGV	TGV
tha	tha
Thai	thaï
Thailand	Thaïlande
That	That
the	the
The	The
THE	THE
tea	thé
theatrical	théâtral
Theatre	Theatre
theater	théâtre
Theater	Théâtre
theaters	théâtres
Theme	Theme
theme	thème
themes	thèmes
Theo	Theo
theo	théori
theory	théorie
Theory	Théorie
theoretical	théorique
therapy	thérapie
Thérèse	Thérèse
baths	thermes
thermometer	thermomètre
teas	thés
These	These
Theses	thèses
They	They
Thiais	Thiais
Thibault	Thibault
third	third
This	This
Thong	Thong
thoracic	thoracique
Thoughts	Thoughts
Thuin	Thuin
thyme	thym
Ti	Ti
Tia	Tia
tiara	tiare
ICT	TIC
ticket	ticket
lukewarm	tiède
yours	tien
want	tiens
wishes	tient
Tier	Tier
third	tiers
stem	tige
Tiger	Tiger
tiger	tigre
Tim	Tim
stamp	timbre
stamps	timbres
Times	Times
timid	timide
tin	tin
firing	tir
fired	tira
drawing	tirage
draws	tire
corkscrew	tire-bouchon
drawn	tirée
shoot	tirer
shooting	tirs
weaves	tisse
Tissot	Tissot
cloth	tissu
tissues	tissus
titanium	titane
Titanic	Titanic
title	titre
securities	titres
holder	titulaire
to	to
To	To
Today	Today
thee	toi
toilet	toilette
washroom	toilettes
roof	toit
roofs	toits
roofing	toiture
Tokyo	Tokyo
tolerance	tolérance
Tom	Tom
fell	tomba
fell	tombé
fall	tombée
fall	tombent
fall	tomber
graves	tombes
tome	tome
tone	ton
Tone	Ton
ton	tonne
barrel	tonneau
thunder	tonnerre
Thunder	Tonnerre
tones	tons
tool	tool
top	top
topography	topographie
Tor	Tor
bullfighter	torero
tornado	tornade
Toronto	Toronto
torrent	torrent
wrong	tort
early	tôt
total	total
Total	Total
totally	totalement
Toto	Toto
touching	touchant
touch	touche
affected	touché
affected	touchée
touch	toucher
affected	touchés
always	toujours
Always	Toujours
Toulouse	Toulouse
tower	tour
Tower	Tour
peat	tourbe
turret	tourelle
tourism	tourisme
Tourism	Tourisme
tourist	touriste
tourist	touristique
tormented	tourmenté
shooting	tournage
turning	tournant
rotating	tournante
turns	tourne
tour	tournée
tours	tournées
turn	tourner
turned	tournés
turn	tournez
towers	tours
all	tous
All	Tous
Toussaint	Toussaint
all	tout
All	Tout
EVERYTHING	TOUT
all	toute
All	Toute
However	Toutefois
all	toutes
Tower	Tower
addicts	toxicomanes
sofie	toxostome
Traceability	traçabilité
trace	trace
traces	traces
plotter	traceur
leaflet	tract
tractor	tracteur
Traction	Traction
trading	trading
tradition	tradition
traditional	traditionnel
Traditional	traditionnelle
traditionally	traditionnellement
Traditional	traditionnels
translator	traducteur
translation	traduction
translate	traduire
translated	traduit
traffic	trafic
tragic	tragique
betrayed	trahi
betray	trahir
Trail	Trail
train	train
Train	Train
sledge	traîneau
Trainer	trainer
drag	traîner
treatment	traitement
treatments	traitements
deal	traiter
caterer	traiteur
features	traits
ride	trajet
trips	trajets
tram	tram
weft	trame
Streetcar	Tramway
slices	tranches
sliced	tranchés
tranquility	tranquilité
quiet	tranquille
tranquility	tranquillité
trans	trans
Transactions	Transactions
transatlantic	transatlantique
transcription	transcription
transcribe	transcrire
transferred	transféré
transferred	transférée
transfer	transférer
transfer	transfert
transfers	transferts
transformation	transformation
transformations	transformations
transforms	transforme
transformed	transformé
Transformed	transformées
transgress	transgresser
transition	transition
forwards	transmet
convey	transmettre
transmitted	transmises
transmission	transmission
Transparency	Transparency
transparent	transparent
transplantation	transplantation
transport	transport
carrying	transportait
carrying	transportant
transports	transporte
carry	transporter
Carriers	transporteurs
transsexual	transsexuelle
stalking	traque
working	travail
Working	Travail
worked	travailla
working	travaillait
working	travaillant
working	travaille
worked	travaillé
worked	travaillée
working	travaillent
work	travailler
worker	travailleur
workers	travailleurs
working	travaillez
work	travaux
crossing	traverse
through	traversé
cross	traverser
crossed	traversèrent
crossed	traversés
ferries	traversiers
Tree	Tree
Trek	Trek
trekking	trekking
tremors	tremblements
temper	trempe
soaked	trempée
Trencavel	Trencavel
Trent	Trent
thirty	trente
thirty-four	trente-quatre
tres	tres
trés	trés
Trés	Trés
very	très
Very	Très
treasure	trésor
Treasure	Trésor
treasures	trésors
sorting	tri
triangle	triangle
Triathlon	triathlon
tribe	tribu
tribune	tribun
court	tribunal
Court	Tribunal
cheating	triche
cheated	triché
cheat	tricher
Tricky	Tricky
tricolor	tricolore
knitting	tricot
quarter	trimestre
Trinity	Trinity
trio	trio
triumph	triompher
trios	trios
triple	triple
Triple	Triple
Trisomy	trisomie
sad	triste
Troi	Troi
three	trois
Three	Trois
Third	Troisième
waterspout	trombe
trombone	trombone
trunk	trompe
wrong	trompent
fool	tromper
trumpet	trompette
trunk	tronc
too	trop
Too	Trop
sidewalk	trottoir
hole	trou
Hole	Trou
disorder	trouble
herd	troupeau
troops	troupes
holes	trous
found	trouvaient
found	trouvait
found	trouve
found	trouvé
found	trouvée
found	trouvent
find	trouver
find	trouverez
found	trouvés
find	trouvez
Find	Trouvez
find	trouvons
Thing	Truc
truck	truck
stuff	trucs
trout	truites
fake	truqué
Trust	Trust
tsunami	tsunami
TTC	TTC
head	tte
you	tu
You	Tu
kills	tue
killed	tuée
killed	tuées
kill	tuent
killer	tueur
Tull	Tull
tumor	tumeur
tumulus	tumulus
Tunis	Tunis
Tunisia	Tunisie
Tunisian	tunisien
Tunisian	tunisiennes
Tunisian	tunisiens
tunnel	tunnel
tunnels	tunnels
tupperware	tupperware
Turbine	Turbine
turbulence	turbulences
Turkey	Turques
Turkey	Turquie
turquoise	turquoise
guardianship	tutelle
Tuvalu	Tuvalu
Piping	tuyauteries
tubing	tuyaux
TV	TV
VAT	TVA
Tweeter	Tweeter
Twist	Twist
Twitter	Twitter
type	type
Type	Type
Types	types
typical	typique
typically	typiquement
typography	typographie
tyrant	tyran
tyranny	tyrannie
yodel	tyrolienne
U	U
UA	UA
ue	ue
EU	UE
UFC	UFC
uk	uk
Ukraine	Ukraine
subsequent	ultérieur
later	ultérieure
later	ultérieurement
ultimate	ultime
Ultra	ultra
UMP	UMP
a	un
A	Un
unanimity	unanimité
a	une
A	Une
united	uni
United	unies
United	Unies
unify	unifier
uniform	uniforme
unilateral	unilatéral
Unilateral	unilatérale
unilaterally	unilatéralement
union	union
Union	Union
single	unique
Single	Unique
only	uniquement
Unique	uniques
unite	unir
united	unis
unites	unit
unitary	unitaire
unit	unité
Unit	Unité
units	unités
world	univers
World	Univers
universal	universel
Universal	universelle
Universal	universels
university	universitaire
academics	universitaires
university	université
University	University
unt	unt
up	up
Up	Up
Update	Update
Uppsala	Uppsala
urban	urbain
Urban	urbaine
Urban	urbains
urgent	urgents
urinary	urinaire
Uruguay	Uruguay
Us	Us
USA	USA
user	usager
users	usagers
uses	usages
use	use
worn	usé
factory	usine
Factory	Usine
factories	usines
wear	usure
usurper	usurpateur
helpful	utile
usable	utilisable
using	utilisant
Using	Utilisant
user	utilisateur
users	utilisateurs
use	utilisation
uses	utilisations
uses	utilise
used	utilisée
used	utilisées
use	utilisent
use	utiliser
used	utilisés
use	utilisez
utility	utilité
Utopia	utopie
uu	uu
UV	UV
V	V
V6	V6
will	va
Va	Va
Vaca	Vaca
vacancy	vacance
holiday	vacances
cow	vache
emptiness	vacuité
vagina	vagin
Vaginal	vaginale
vain	vain
wins	vainc
overcome	vaincre
defeated	vaincu
defeated	vaincue
vainly	vainement
winner	vainqueur
Winner	Vainqueur
minnows	vairons
will	vais
vessel	vaisseau
crockery	vaisselle
val	val
worth	valait
Vale	Vale
Valentine	valentin
Valerie	Valerie
Valérie	Valérie
value	valeur
valorous	valeureux
values	valeurs
validation	validation
validated	validé
validate	valider
suitcase	valise
bags	valises
Valley	Valley
hilly	vallonné
valorization	valorisation
develop	valoriser
vals	vals
earned	valu
value	value
earned	valut
valve	valve
vampire	vampire
Vande	Vande
Vane	Vane
Vanessa	Vanessa
valve	vanne
boast	vanter
Vanuatu	Vanuatu
steam	vapeur
Steam	Vapeur
variables	variables
variation	variation
varies	varie
varied	varié
varied	variées
varied	variés
variety	variété
variety	variétés
Vas	Vas
vase	vase
washbasins	vasques
vassals	vassaux
wide	vaste
extensive	vastes
vau	vau
Vaughn	Vaughn
worth	vaut
veal	veau
lived	vécu
experienced	vécue
star	vedette
Vegeta	Vegeta
vegetable	végétale
vegetable	végétales
vegetation	végétation
plant	végétaux
vehicle	véhicule
vehicles	véhicules
eve	veille
watch	veiller
bike	vélo
velocity	vélocité
came	venaient
from	venant
sells	vend
vintage	vendange
seller	vendeur
saleswomen	vendeuses
sell	vendez
sale	vendre
Friday	vendredi
Fridays	vendredis
sold	vendu
sold	vendue
sold	vendues
come	venez
Come	Venez
Venezuela	Venezuela
revenged	vengea
revenge	vengeance
vengeance	vengeances
come	venir
Venice	Venise
Venom	Venom
just	venons
wind	vent
sale	vente
sales	ventes
stomach	ventre
wind	vents
arrival	venue
goings	venues
from	venus
Venus	Vénus
veranda	véranda
verb	verbe
verbs	verbes
greenish	verdâtre
verdict	verdict
greenery	verdure
orchards	vergers
ice	verglas
truthful	véridiques
check	vérification
checks	vérifications
checks	vérifie
checked	vérifiée
real	véritable
Real	Véritable
truly	véritablement
truth	vérité
Vermont	Vermont
Vernie	Vernie
polish	vernis
Speedwell	Véronique
will	verra
glass	verre
Glassware	Verrerie
glasses	verres
see	verrons
lock	verrou
locking	verrouillage
lock	verrouiller
to	vers
To	Vers
Versailles	versailles
pays	verse
versed	versé
paid	versée
pay	verser
Version	Version
green	vert
green	verte
Vertebral	vertébrale
green	vertes
green	verts
virtue	vertu
virtues	vertus
bladder	vessie
jacket	veste
Jacket	Veste
cloakrooms	vestiaires
remains	vestiges
clothing	vestimentaires
clothing	vêtement
clothing	vêtements
vet	vétérinaire
Vet	Vétérinaire
dressed	vêtu
wants	veuille
want	veulent
wants	veut
widow	veuve
Widow	Veuve
want	veux
via	via
Via	Via
viable	viable
viable	viables
viaduct	viaduc
meat	viande
meats	viandes
vice-president	vice-président
Vice-President	Vice-Président
vices	vices
Vicky	Vicky
Victim	Victime
casualties	victimes
victories	victoires
Victor	Victor
Victoria	Victoria
victorious	victorieuse
Victory	Victory
empty	vide
video	vidéo
videos	vidéos
Empty	vides
life	vie
Life	Vie
old	vieil
antiquated	vieillot
will	viendront
come	viennent
Come	Viennent
Viennese	viennois
pastries	viennoiseries
just	viens
comes	vient
Comes	Vient
virgin	vierge
virgin	vierges
Vietnam	Vietnam
Vietnam	Viêtnam
old	vieux
Old	Vieux
bright	vif
vigilance	vigilance
vigil	vigile
vine	vigne
wineries	vignerons
vineyards	vignobles
vile	vil
naughty	vilain
Naughty	Vilain
vile	vile
villa	villa
Villa	Villa
village	village
Villages	Villages
villas	villas
city	ville
City	Ville
wine	vin
Wine	Vin
Vinci	Vinci
twenty	vingt
Wines	vins
came	vint
rape	viol
viola	viola
purplish	violacé
violation	violation
violations	violations
viol	viole
Viol	Viole
violently	violemment
violence	violence
violence	violences
Violent	violentes
Violetta	Violetta
violin	violon
Viper	Vipère
vipers	vipères
turn	virage
turns	vire
fired	viré
turn	virer
Virgin	Virgin
Virginia	Virginie
virtually	virtuellement
virus	virus
screw	vis
visa	visa
Visa	Visa
faces	visages
sought	visaient
to	visant
vis-a-vis	vis-à-vis
sight	visée
aim	visent
viewfinder	viseur
visible	visible
obviously	visiblement
vision	vision
visit	visite
visit	visitent
visit	visiter
visitors	visiteurs
visit	visitez
viscous	visqueux
visualize	visualiser
visual	visuel
lives	vit
Vita	Vita
vital	vitale
vitality	vitalité
vitamin	vitamine
quickly	vite
speed	vitesse
wine	viticole
showcase	vitrine
perennial	vivace
liveliness	vivacité
living	vivant
Living	vivantes
viva	vive
Viva	Vive
sharply	vivement
living	vivent
bright	vives
stimulating	vivifiant
live	vivre
VO	VO
voice	vocale
vocation	vocation
greeting	voeux
vogue	vogue
sail	voguer
way	voie
Way	Voie
see	voient
pathways	voies
Routes	Voies
here	voilà
Here	Voilà
sail	voile
view	voir
View	Voir
indeed	voire
see	vois
neighbor	voisin
Voisine	Voisine
neighbors	voisines
sees	voit
car	voiture
voice	voix
Voice	Voix
flight	vol
poultry	volailles
flying	volant
Flying	volante
volatile	volatile
volatility	volatilité
volcano	volcan
Volcanoes	volcans
stolen	volé
flight	volée
stolen	volées
fly	voler
Fly	Voler
stolen	volés
thief	voleur
voluntary	volontaire
volunteers	volontaires
will	volonté
Will	Volonté
willingly	volontiers
flights	vols
Voltaire	Voltaire
Vaulting	Voltige
Outfielder	voltigeur
volume	volume
volumes	volumes
sensuousness	volupté
Volvo	Volvo
Vom	Vom
von	von
Von	Von
will	vont
your	vos
Your	Vos
Vot	Vot
Voting	Vote
your	votre
Your	Votre
would	voudrais
would	voudrait
wanting	voulant
want	voulez
wanted	vouliez
want	vouloir
want	voulons
desired	voulu
wanted	voulut
you	vous
You	Vous
YOU	VOUS
vault	voute
vault	voûte
travel	voyage
Travel	Voyage
travel	voyagent
travel	voyager
Travel	Voyager
traveling	voyages
traveler	voyageur
travelers	voyageurs
saw	voyait
seer	voyant
Seer	Voyant
vowels	voyelles
see	voyez
see	voyons
Loose	vrac
real	vrai
real	vraie
really	vraiment
Really	Vraiment
real	vrais
Probably	Vraisemblablement
likelihood	vraisemblance
VS	VS
view	vue
seen	vus
w	w
W	W
Wales	Wales
Wallace	Wallace
Walt	Walt
Warning	Warning
Wars	Wars
Water	Water
Watson	Watson
wave	wave
wc	wc
WC	WC
weather	weather
web	web
Web	Web
webmaster	webmaster
Wednesday	Wednesday
Weekend	Weekend
Well	Well
What	What
qui	which
Wight	Wight
Wikisource	Wikisource
Will	Will
Wimax	Wimax
Win	Win
Winding	Winding
Windows	Windows
Winnie	Winnie
Winter	Winter
Wisconsin	Wisconsin
wolof	wolof
Woman	Woman
Wonder	Wonder
Woods	Woods
Woody	Woody
world	world
World	World
x	x
X	X
XIV	XIVe
XP	XP
XVIII	XVIII
XX	XX
Twentieth	XXe
XX	XXème
there	y
Y	Y
Yamaha	Yamaha
Yankees	Yankees
Yann	Yann
Yao	Yao
Yaoundé	Yaoundé
yard	yard
Yemen	Yémen
YES	YES
eyes	yeux
Yo	Yo
Yoko	Yoko
Yolo	Yolo
York	York
you	you
You	You
Yugoslavia	Yougoslavie
your	your
Your	Your
Youth	Youth
Youtube	Youtube
YouTube	YouTube
Yves	Yves
zebra	zèbre
Zeeman	Zeeman
zero	zéro
Zeus	Zeus
Zimbabwe	Zimbabwe
ZNIEFF	ZNIEFF
Zoe	Zoé
shingles	zona
area	zone
areas	zones
zoo	zoo
zoophile	zoophile
zu	zu
